DATA,DESCRICAO,DOCUMENTO,CREDITO,DEBITO,SALDO,BANCO,CONTA,SUBCONTA,FILE_PATH
2024-01-02,PAGAMENTO BOLETO PACKPAR EMBALAGENS,,0.0,196.56,7087.8,INTER,Despesa com produtos,Materiais de Consumo,../data/raw/BANCO INTER-2024.xlsx
2024-01-02,PIX RECEBIDO CLEYTON GALEGO SOCIEDADE I. ADVOCACIA,,3700.0,0.0,10787.8,INTER,Receita de vendas,Outras vendas,../data/raw/BANCO INTER-2024.xlsx
2024-01-03,PIX RECEBIDO FERNANDA SARAIVA E SILVA,,40.0,0.0,10827.8,INTER,Receita com serviços,Manutenção s/ Garantia,../data/raw/BANCO INTER-2024.xlsx
2024-01-03,PIX RECEBIDO LEONARDO JOSE SIQUEIRA CASTILHOS,,380.0,0.0,11207.8,INTER,Receita com serviços,Manutenção s/ Garantia,../data/raw/BANCO INTER-2024.xlsx
2024-01-03,PIX ENVIADO GOVERNO DO PARANA SECRETARIA DE ESTADO - GRPR,,0.0,787.86,10419.94,INTER,Despesas tributárias ,Outras,../data/raw/BANCO INTER-2024.xlsx
2024-01-03,PIX RECEBIDO LEONARDO JOSE SIQUEIRA CASTILHOS,,35.0,0.0,10454.94,INTER,Receita com serviços,Manutenção s/ Garantia,../data/raw/BANCO INTER-2024.xlsx
2024-01-04,TED RECEBIDA LIANGZHONG HU,,365.0,0.0,10819.94,INTER,Receita com serviços,Outras,../data/raw/BANCO INTER-2024.xlsx
2024-01-04,PIX RECEBIDO INGRID ELIZABETH BUSCHLE,,237.5,0.0,11057.44,INTER,Receita com serviços,Manutenção s/ Garantia,../data/raw/BANCO INTER-2024.xlsx
2024-01-05,PIX ENVIADO THIAGO IANUCH MARIN,,0.0,1603.3,9454.14,INTER,Despesa com serviços,Outras,../data/raw/BANCO INTER-2024.xlsx
2024-01-05,PIX ENVIADO LUIZ GUILHERME KRAUSE,,0.0,1329.66,8124.48,INTER,Despesa com serviços,Outras,../data/raw/BANCO INTER-2024.xlsx
2024-01-05,PIX ENVIADO SILVIA-CONTABILIDADE HONORÁRIOS,,0.0,812.0,7312.48,INTER,Despesas administrativas,Contabilidade,../data/raw/BANCO INTER-2024.xlsx
2024-01-05,PIX ENVIADO CLAUDIO - PRO-LABORE,,0.0,1335.0,5977.48,INTER,Despesa com pessoal,Pró labore,../data/raw/BANCO INTER-2024.xlsx
2024-01-05,PIX ENVIADO ELISABETE - PRO-LABORE,,0.0,1335.0,4642.48,INTER,Despesa com pessoal,Pró labore,../data/raw/BANCO INTER-2024.xlsx
2024-01-08,PIX RECEBIDO ACRICIO LOPES CANCADO FILHO,,440.0,0.0,5082.48,INTER,Receita com serviços,Manutenção s/ Garantia,../data/raw/BANCO INTER-2024.xlsx
2024-01-08,PAGAMENTO BOLETO CIEE - ESTAGIÁRIOS,,0.0,1374.69,3707.79,INTER,Despesa com pessoal,Salário,../data/raw/BANCO INTER-2024.xlsx
2024-01-08,PAGAMENTO BOLETO SPRINGER CARRIER,,0.0,371.29,3336.5,INTER,Despesa com serviços,Peças,../data/raw/BANCO INTER-2024.xlsx
2024-01-08,PAGAMENTO BOLETO WHITE MARTINS,,0.0,48.42,3288.08,INTER,Despesa com produtos,Materiais de Consumo,../data/raw/BANCO INTER-2024.xlsx
2024-01-08,PIX RECEBIDO MARCOS JUSTINO GUARDA,,780.0,0.0,4068.08,INTER,Receita com serviços,Manutenção s/ Garantia,../data/raw/BANCO INTER-2024.xlsx
2024-01-09,PIX RECEBIDO CAMILA VERBISKI DE ANDRADE,,40.0,0.0,4108.08,INTER,Receita com serviços,Manutenção s/ Garantia,../data/raw/BANCO INTER-2024.xlsx
2024-01-09,PIX RECEBIDO LUCI ISABEL OLIARI LIRA,,380.0,0.0,4488.08,INTER,Receita com serviços,Manutenção s/ Garantia,../data/raw/BANCO INTER-2024.xlsx
2024-01-09,PIX RECEBIDO MARCUS VINICIUS HARUO OSHIMA,,250.0,0.0,4738.08,INTER,Receita com serviços,Manutenção s/ Garantia,../data/raw/BANCO INTER-2024.xlsx
2024-01-10,PIX RECEBIDO JANAINA CASSIA P DEGRAF MATEUS ,,520.0,0.0,5258.08,INTER,Receita com serviços,Manutenção s/ Garantia,../data/raw/BANCO INTER-2024.xlsx
2024-01-10,PIX RECEBIDO LEONAM GARCIA,,365.0,0.0,5623.08,INTER,Receita com serviços,Manutenção s/ Garantia,../data/raw/BANCO INTER-2024.xlsx
2024-01-11,PIX RECEBIDO THIAGO RAFAEL DACKIW,,380.0,0.0,6003.08,INTER,Receita com serviços,Manutenção s/ Garantia,../data/raw/BANCO INTER-2024.xlsx
2024-01-12,PIX RECEBIDO ANDREA ALEXANDRE,,250.0,0.0,6253.08,INTER,Receita com serviços,Manutenção s/ Garantia,../data/raw/BANCO INTER-2024.xlsx
2024-01-12,PIX RECEBIDO MARIANA DAL PRA,,740.0,0.0,6993.08,INTER,Receita com serviços,Manutenção s/ Garantia,../data/raw/BANCO INTER-2024.xlsx
2024-01-12,PIX RECEBIDO JOSE RONALDO RIBEIRO,,340.0,0.0,7333.08,INTER,Receita com serviços,Manutenção s/ Garantia,../data/raw/BANCO INTER-2024.xlsx
2024-01-12,PIX ENVIADO LUIZ GUILHERME - LANCHES HORAS EXTRAS,,0.0,40.0,7293.08,INTER,Despesa com pessoal,Alimentação (VR VA),../data/raw/BANCO INTER-2024.xlsx
2024-01-15,PIX ENVIADO CAMILA AP. M. RIBEIRO - MULTA SPIN,,0.0,208.26,7084.82,INTER,Despesas administrativas,Veiculos,../data/raw/BANCO INTER-2024.xlsx
2024-01-15,PAGTO DE BOLETO DUFRIO,,0.0,720.45,6364.37,INTER,Despesa com produtos,Outras,../data/raw/BANCO INTER-2024.xlsx
2024-01-15,PIX RECEBIDO AYRTON LANGMAN BARUTH,,40.0,0.0,6404.37,INTER,Receita com serviços,Manutenção s/ Garantia,../data/raw/BANCO INTER-2024.xlsx
2024-01-15,PIX RECEBIDO HENRIQUE GASPARINI SILVANO,,365.0,0.0,6769.37,INTER,Receita com serviços,Manutenção s/ Garantia,../data/raw/BANCO INTER-2024.xlsx
2024-01-15,PAGTO CARTÃO AMERICAN,,0.0,1919.46,4849.91,INTER,Transferência (Crédito),Aplicação,../data/raw/BANCO INTER-2024.xlsx
2024-01-15,PAGTO BOLETO SPRINGER CARRIER,,0.0,11.45,4838.46,INTER,Despesa com serviços,Peças,../data/raw/BANCO INTER-2024.xlsx
2024-01-16,COPEL - PAGTO ENERGIA LJ 3,,0.0,161.74,4676.72,INTER,Despesas administrativas,Energia,../data/raw/BANCO INTER-2024.xlsx
2024-01-16,COPEL - PAGTO ENERGIA LJ 4,,0.0,70.78,4605.94,INTER,Despesas administrativas,Energia,../data/raw/BANCO INTER-2024.xlsx
2024-01-16,COPEL - PAGTO ENERGIA LJ 6,,0.0,422.75,4183.19,INTER,Despesas administrativas,Energia,../data/raw/BANCO INTER-2024.xlsx
2024-01-17,PIX ENVIADO ON TECNOLOGIA DE MOBILIDADE URBANA - ESTAR,,0.0,30.0,4153.19,INTER,Despesa com pessoal,Transporte (VT),../data/raw/BANCO INTER-2024.xlsx
2024-01-17,PIX RECEBIDO RUI LUIZ DA SILVA SILVEIRA,,515.0,0.0,4668.19,INTER,Receita com serviços,Manutenção s/ Garantia,../data/raw/BANCO INTER-2024.xlsx
2024-01-17,PIX RECEBIDO ROSELY ZOSCHKE COSTA,,90.0,0.0,4758.19,INTER,Receita com serviços,Manutenção s/ Garantia,../data/raw/BANCO INTER-2024.xlsx
2024-01-19,PIX ENVIADO GOVERNO DO PARANA - IPVA/2024 RANGER - 1 DE 5,,0.0,975.61,3782.58,INTER,Despesas tributárias ,IPVA,../data/raw/BANCO INTER-2024.xlsx
2024-01-19,PIX ENVIADO LUIZ - PAGTO ADIANTAMENTO DE SALÁRIO,,0.0,800.0,2982.58,INTER,Despesa com pessoal,Salário,../data/raw/BANCO INTER-2024.xlsx
2024-01-19,PAGTO FATURA CARTÃO INTER,,0.0,2642.74,339.84,INTER,Transferência (Crédito),Aplicação,../data/raw/BANCO INTER-2024.xlsx
2024-01-19,PIX RECEBIDO LEILA MARIA BARON,,430.0,0.0,769.84,INTER,Receita com serviços,Manutenção s/ Garantia,../data/raw/BANCO INTER-2024.xlsx
2024-01-22,COMPRA CARTÃO - FERRY-BOAT GUARATUBA - ATEND. PANASONIC,,0.0,8.9,760.94,INTER,Despesa com produtos,Fretes e Pedagios,../data/raw/BANCO INTER-2024.xlsx
2024-01-22,COMPRA CARTÃO - FERRY-BOAT GUARATUBA - ATEND. PANASONIC,,0.0,8.9,752.04,INTER,Despesa com produtos,Fretes e Pedagios,../data/raw/BANCO INTER-2024.xlsx
2024-01-22,PIX RECEBIDO DE INNOVARE - CENTRO DE SAUDE E REABILIT ,,3900.0,0.0,4652.04,INTER,Receita de vendas,Outras vendas,../data/raw/BANCO INTER-2024.xlsx
2024-01-22,PIX RECEBIDO FRESNOMAQ IND. DE MAQUINAS S/A - NFS-e,,2433.2,0.0,7085.24,INTER,Receita de vendas,Outras vendas,../data/raw/BANCO INTER-2024.xlsx
2024-01-22,PIX RECEBIDO MARCIA CRISTINA A PRATA,,590.0,0.0,7675.24,INTER,Receita com serviços,Manutenção s/ Garantia,../data/raw/BANCO INTER-2024.xlsx
2024-01-22,PIX ENVIADO NICOLAU DO ROSÁRIO - BARCO-ILHA GUARAQUEÇABA ATEND. PANASONIC,,0.0,300.0,7375.24,INTER,Despesa com serviços,Transporte,../data/raw/BANCO INTER-2024.xlsx
2024-01-24,PIX RECEBIDO ELTON MARTINS,,260.0,0.0,7635.24,INTER,Receita com serviços,Manutenção s/ Garantia,../data/raw/BANCO INTER-2024.xlsx
2024-01-24,PIX RECEBIDO OSMAR GOMES,,350.0,0.0,7985.24,INTER,Receita com serviços,Manutenção s/ Garantia,../data/raw/BANCO INTER-2024.xlsx
2024-01-25,PIX RECEBIDO MIRIAM APARECIDA SALOMÃO EASTWOOD POKES,,450.0,0.0,8435.24,INTER,Receita com serviços,Manutenção s/ Garantia,../data/raw/BANCO INTER-2024.xlsx
2024-01-25,PIX RECEBIDO MICHELE FERREIRA DE LIMA,,695.0,0.0,9130.24,INTER,Receita com serviços,Manutenção s/ Garantia,../data/raw/BANCO INTER-2024.xlsx
2024-01-25,PIX RECEBIDO JOSÉ VIRGILIO CORREA,,420.0,0.0,9550.24,INTER,Receita com serviços,Manutenção s/ Garantia,../data/raw/BANCO INTER-2024.xlsx
2024-01-26,PIX RECEBIDO PROTECHNIK - REPRESENTACOES DE EQUIPA,,370.0,0.0,9920.24,INTER,Receita com serviços,Manutenção s/ Garantia,../data/raw/BANCO INTER-2024.xlsx
2024-01-26,PIX ENVIADO CLAUDIO -REEMBOLSO DE DESPESAS COM CARRO,,0.0,200.0,9720.24,INTER,Despesas administrativas,Veiculos,../data/raw/BANCO INTER-2024.xlsx
2024-01-26,PIX ENVIADO MATHEUS -PAGTO SERVIÇOS TERCEIRO,,0.0,252.0,9468.24,INTER,Despesa com serviços,Mão de obra,../data/raw/BANCO INTER-2024.xlsx
2024-01-29,PIX RECEBIDO LUCIANE LINHARES LUZZI,,440.0,0.0,9908.24,INTER,Receita com serviços,Manutenção s/ Garantia,../data/raw/BANCO INTER-2024.xlsx
2024-01-29,PIX ENVIADO ASSOCIAÇÃO METROCARD,,0.0,91.15,9817.09,INTER,Despesa com pessoal,Transporte (VT),../data/raw/BANCO INTER-2024.xlsx
2024-01-30,COMPRA CARTÃO  - VILA IZABEL MATERIAIS CONSTR.,,0.0,6.0,9811.09,INTER,Despesas administrativas,Manutenção predial,../data/raw/BANCO INTER-2024.xlsx
2024-01-31,PIX RECEBIDO MAXIMILIANO R DELIBERADOR,,385.0,0.0,10196.09,INTER,Receita com serviços,Manutenção s/ Garantia,../data/raw/BANCO INTER-2024.xlsx
2024-01-31,PIX RECEBIDO MARIA ILDA DOS SANTOS VUNDERVARDE,,1040.0,0.0,11236.09,INTER,Receita com serviços,Manutenção s/ Garantia,../data/raw/BANCO INTER-2024.xlsx
2024-01-31,PIX RECEBIDO BRUNO HENRIQUE NUNES QUINTELA,,220.0,0.0,11456.09,INTER,Receita com serviços,Manutenção s/ Garantia,../data/raw/BANCO INTER-2024.xlsx
2024-01-31,PIX ENVIADO KAIO SPURI LIMA,,0.0,228.0,11228.09,INTER,Despesa com serviços,Outras,../data/raw/BANCO INTER-2024.xlsx
2024-01-31,"PIX ENVIADO M,ATHEUS - PAGTO SERVIÇOS DE TERCEIROS",,0.0,840.0,10388.09,INTER,Despesa com serviços,Mão de obra,../data/raw/BANCO INTER-2024.xlsx
2024-01-31,PIX ENVIADO LUIZ - DESPESAS COM CARRO,,0.0,200.0,10188.09,INTER,Despesas administrativas,Manutenção veículo,../data/raw/BANCO INTER-2024.xlsx
2024-01-31,PIX RECEBIDO MARIA LUIZA DIAS,,105.0,0.0,10293.09,INTER,Receita com serviços,Manutenção s/ Garantia,../data/raw/BANCO INTER-2024.xlsx
2024-02-01,PIX RECEBIDO MIRIAM KELLI DE SOUZA FERREIRA,,440.0,0.0,10733.09,INTER,Receita com serviços,Manutenção s/ Garantia,../data/raw/BANCO INTER-2024.xlsx
2024-02-01,PIX RECEBIDO MICHAEL RIICHI YAMANE,,200.0,0.0,10933.09,INTER,Receita com serviços,Manutenção s/ Garantia,../data/raw/BANCO INTER-2024.xlsx
2024-02-01,PIX RECEBIDO ASTOM COMERCIO E SERVIÇOS,,349.0,0.0,11282.09,INTER,Receita de vendas,Outras vendas,../data/raw/BANCO INTER-2024.xlsx
2024-02-01,PIX RECEBIDO DORIANNE G ALVES SOUZA,,600.0,0.0,11882.09,INTER,Receita com serviços,Manutenção s/ Garantia,../data/raw/BANCO INTER-2024.xlsx
2024-02-01,PIX RECEBIDO JESSICA FERNANDA SANTOS GOMES,,280.0,0.0,12162.09,INTER,Receita com serviços,Manutenção s/ Garantia,../data/raw/BANCO INTER-2024.xlsx
2024-02-02,PIX RECEBIDO SÁVIO PECLAT COELHO,,35.0,0.0,12197.09,INTER,Receita com serviços,Manutenção s/ Garantia,../data/raw/BANCO INTER-2024.xlsx
2024-02-04,COMPRA CARTÃO - 9PAY S*REDE FUKAMI 09 CURITIBA,,0.0,12.0,12185.09,INTER,Despesas administrativas,Outras,../data/raw/BANCO INTER-2024.xlsx
2024-02-04,COMPRA CARTÃO - FERRY-BOAT GUARATUBA - ATEND. PANASONIC,,0.0,8.9,12176.19,INTER,Despesa com produtos,Fretes e Pedagios,../data/raw/BANCO INTER-2024.xlsx
2024-02-05,PIX RECEBIDO LETICIA TABORDA PANCINI,,705.0,0.0,12881.19,INTER,Receita com serviços,Manutenção s/ Garantia,../data/raw/BANCO INTER-2024.xlsx
2024-02-05,PIX ENVIADO GOVERNO DO PARANA SECRETARIA DE ESTADO - GRPR,,0.0,1665.49,11215.7,INTER,Despesas tributárias ,Outras,../data/raw/BANCO INTER-2024.xlsx
2024-02-06,PIX ENVIADO BRENDA - PAGAMENTO DE SALÁRIO,,0.0,833.05,10382.65,INTER,Despesa com pessoal,Salário,../data/raw/BANCO INTER-2024.xlsx
2024-02-06,PIX ENVIADO LUIZ GUILHERME - PAGAMENTO DE SALÁRIO,,0.0,1729.39,8653.26,INTER,Despesa com pessoal,Salário,../data/raw/BANCO INTER-2024.xlsx
2024-02-06,PIX ENVIADO ELISABETE - PRO-LABORE,,0.0,1352.8,7300.46,INTER,Despesa com pessoal,Pró labore,../data/raw/BANCO INTER-2024.xlsx
2024-02-06,PIX ENVIADO CLAUDIO - PRO-LABORE,,0.0,1352.8,5947.66,INTER,Despesa com pessoal,Pró labore,../data/raw/BANCO INTER-2024.xlsx
2024-02-07,PIX ENVIADO NICOLAU DO ROSÁRIO - BARCO-ILHA GUARAQUEÇABA ATEND. PANASONIC,,0.0,300.0,5647.66,INTER,Despesa com produtos,Fretes e Pedagios,../data/raw/BANCO INTER-2024.xlsx
2024-02-07,PIX ENVIADO GENILSON DE ALCANTARA SILVA - REF. CONSERTO FIESTA,,0.0,251.0,5396.66,INTER,Despesas administrativas,Manutenção veículo,../data/raw/BANCO INTER-2024.xlsx
2024-02-08,PIX ENVIADO MIRIAM KELLI DE SOUZA FERREIRA,,30.0,0.0,5426.66,INTER,Receita com serviços,Outras,../data/raw/BANCO INTER-2024.xlsx
2024-02-08,PAGAMENTO DE ALUGUEL,,0.0,4315.03,1111.63,INTER,Despesas administrativas,Aluguel imóvel,../data/raw/BANCO INTER-2024.xlsx
2024-02-08,PIX RECEBIDO FABRÍZIA BORGES GUIMARÃES,,560.0,0.0,1671.63,INTER,Receita com serviços,Manutenção s/ Garantia,../data/raw/BANCO INTER-2024.xlsx
2024-02-08,PAGAMENTO CIEE - ESTAGIÁRIO,,0.0,500.19,1171.44,INTER,Despesa com pessoal,Salário,../data/raw/BANCO INTER-2024.xlsx
2024-02-08,COMPRA CARTÃO NO ESTABELECIMENTO PAG*JOSEALDENITAVARES CURITIBA,,0.0,43.0,1128.44,INTER,Despesas administrativas,Outras,../data/raw/BANCO INTER-2024.xlsx
2024-02-09,COMPRA CARTÃO NO ESTABELECIMENTO CID ROCHA JUNIOR CURITIBA BRA,,0.0,26.05,1102.39,INTER,Despesas administrativas,Outras,../data/raw/BANCO INTER-2024.xlsx
2024-02-14,PIX RECEBIDO WESLEY OLIVEIRA FURRIEL,,1020.0,0.0,2122.39,INTER,Receita com serviços,Manutenção s/ Garantia,../data/raw/BANCO INTER-2024.xlsx
2024-02-14,PIX ENVIADO BRENDA - PAGAMENTO DE RESCISÃO DO CONTRATO,,0.0,10.69,2111.7,INTER,Despesa com pessoal,Aviso prévio / Multa rescisória,../data/raw/BANCO INTER-2024.xlsx
2024-02-14,PIX ENVIADO DEPARTAMENTO DE TRANSITO DETRAN,,0.0,156.18,1955.52,INTER,Despesas tributárias ,Outras,../data/raw/BANCO INTER-2024.xlsx
2024-02-14,PIX ENVIADO GOVERNO DO PARANA - IPVA/2024 FIESTA - 1 DE 5,,0.0,124.53,1830.99,INTER,Despesas tributárias ,IPVA,../data/raw/BANCO INTER-2024.xlsx
2024-02-14,PAGTO DE TÍTULO WHITE MARTINS,,0.0,48.42,1782.57,INTER,Despesa com produtos,Materiais de Consumo,../data/raw/BANCO INTER-2024.xlsx
2024-02-14,PIX ENVIADO LAERTES-DESPACHANTE C/ TRANSF. ,,0.0,540.0,1242.57,INTER,Despesa com serviços,Mão de obra,../data/raw/BANCO INTER-2024.xlsx
2024-02-14,PAGTO DE TÍTULO WHITE MARTINS,,0.0,162.78,1079.79,INTER,Despesa com produtos,Materiais de Consumo,../data/raw/BANCO INTER-2024.xlsx
2024-02-16,PIX RECEBIDO SERGIO C ARENHART,,923.0,0.0,2002.79,INTER,Receita com serviços,Manutenção s/ Garantia,../data/raw/BANCO INTER-2024.xlsx
2024-02-16,PIX RECEBIDO YUMI IMAI DE SOUZA,,735.0,0.0,2737.79,INTER,Receita com serviços,Manutenção s/ Garantia,../data/raw/BANCO INTER-2024.xlsx
2024-02-19,PIX RECEBIDO ELDREY SEOLIN GALINDO,,1000.0,0.0,3737.79,INTER,Receita de vendas,Outras vendas,../data/raw/BANCO INTER-2024.xlsx
2024-02-20,PIX RECEBIDO JOÃO JORGE SANTIAGO ANTUNES,,500.0,0.0,4237.79,INTER,Receita com serviços,Manutenção s/ Garantia,../data/raw/BANCO INTER-2024.xlsx
2024-02-20,PIX RECEBIDO JOAO GUILHERME FREITAS PEREIRA,,385.0,0.0,4622.79,INTER,Receita com serviços,Manutenção s/ Garantia,../data/raw/BANCO INTER-2024.xlsx
2024-02-21,PIX ENVIADO GOVERNO DO PARANA - IPVA/2024 RANGER - 2 DE 5,,0.0,975.61,3647.18,INTER,Despesas tributárias ,IPVA,../data/raw/BANCO INTER-2024.xlsx
2024-02-21,PIX ENVIADO ROBSON - DEVOLUÇÃO DE TROCO PARA CLIENTE,,0.0,30.0,3617.18,INTER,Despesa com serviços,Outras,../data/raw/BANCO INTER-2024.xlsx
2024-02-22,PIX RECEBIDO NILTON REGINALDO GABARDO,,1370.0,0.0,4987.18,INTER,Receita de vendas,Outras vendas,../data/raw/BANCO INTER-2024.xlsx
2024-02-22,PIX RECEBIDO NADIA SALIBA TARAZI VALETON,,455.0,0.0,5442.18,INTER,Receita com serviços,Manutenção s/ Garantia,../data/raw/BANCO INTER-2024.xlsx
2024-02-23,PIX RECEBIDO RENATA PRADO SALATA,,450.0,0.0,5892.18,INTER,Receita com serviços,Manutenção s/ Garantia,../data/raw/BANCO INTER-2024.xlsx
2024-02-23,PIX RECEBIDO WG CONSERTOS E ASSITENCIA TÉCNICA,,300.0,0.0,6192.18,INTER,Receita de vendas,Outras vendas,../data/raw/BANCO INTER-2024.xlsx
2024-02-23,PIX ENVIADO  LUIS PEREIRA - DEVOLUÇÃO RECEBIDO C/ CARTÃO VISA C. EM 06/02,,0.0,80.0,6112.18,INTER,Transferência (Débito),Transferência / Reembolso,../data/raw/BANCO INTER-2024.xlsx
2024-02-23,PIX ENVIADO GOVERNO DO PARANA - TAXA DE CORPO DE BOMBEIROS,,0.0,118.49,5993.69,INTER,Despesas tributárias ,Outras,../data/raw/BANCO INTER-2024.xlsx
2024-02-23,PIX RECEBIDO EDUARDO BOTELHO CORDEIRO,,40.0,0.0,6033.69,INTER,Receita com serviços,Manutenção s/ Garantia,../data/raw/BANCO INTER-2024.xlsx
2024-02-26,PIX ENVIADO RONALDO-DIFERENÇA DE VT REF. AUMENTO DE VALOR METROCARD,,0.0,18.0,6015.69,INTER,Despesa com pessoal,Transporte (VT),../data/raw/BANCO INTER-2024.xlsx
2024-02-26,PIX RECEBIDO ALCEU ANTIMO VEZOZZO FILHO,,400.0,0.0,6415.69,INTER,Receita com serviços,Manutenção s/ Garantia,../data/raw/BANCO INTER-2024.xlsx
2024-02-26,PIX ENVIADO ADRIANA DOS SANTOS SEIXAS P PAGTO VT RE. 4 DIAS,,0.0,48.0,6367.69,INTER,Despesa com pessoal,Alimentação (VR VA),../data/raw/BANCO INTER-2024.xlsx
2024-02-26,PIX ENVIADO CLAUDIO - REEMBOLSO DE GASTOS C/CARRO E MAT. LIMPEZA,,0.0,1250.0,5117.69,INTER,Despesas administrativas,Veiculos,../data/raw/BANCO INTER-2024.xlsx
2024-02-27,PIX ENVIADO ASSOCIACAO METROCARD - VT RONALDO,,0.0,110.9,5006.79,INTER,Despesa com pessoal,Transporte (VT),../data/raw/BANCO INTER-2024.xlsx
2024-02-28,PIX RECEBIDO FERNANDO OLIVEIRA CAMBRAIA,,40.0,0.0,5046.79,INTER,Receita com serviços,Manutenção s/ Garantia,../data/raw/BANCO INTER-2024.xlsx
2024-02-28,PIX RECEBIDO JULIANA DE SOUSA MARQUES,,300.0,0.0,5346.79,INTER,Receita com serviços,Manutenção s/ Garantia,../data/raw/BANCO INTER-2024.xlsx
2024-02-29,PIX ENVIADO MEGA AR STORE - NF 29548,,0.0,141.18,5205.61,INTER,Despesa com serviços,Peças,../data/raw/BANCO INTER-2024.xlsx
2024-02-29,PIX RECEBIDO DAYANNE FRAIZ,,135.0,0.0,5340.61,INTER,Receita com serviços,Manutenção s/ Garantia,../data/raw/BANCO INTER-2024.xlsx
2024-02-29,PIX ENVIADO AUTO PECAS RODA CAR - PEÇAS P/ CARRO FIESTA,,0.0,34.0,5306.61,INTER,Despesas administrativas,Peças/acessórios veiculos,../data/raw/BANCO INTER-2024.xlsx
2024-02-29,PIX RECEBIDO ELIANE MENEGUETTE,,200.0,0.0,5506.61,INTER,Receita com serviços,Manutenção s/ Garantia,../data/raw/BANCO INTER-2024.xlsx
2024-03-01,PIX RECEBIDO MARCELO INOCENCIO,,190.0,0.0,5696.61,INTER,Receita com serviços,Manutenção s/ Garantia,../data/raw/BANCO INTER-2024.xlsx
2024-03-01,COMPRA CARTÃO - FERRY-BOAT GUARATUBA - ATEND. PANASONIC,,0.0,8.9,5687.71,INTER,Despesa com produtos,Fretes e Pedagios,../data/raw/BANCO INTER-2024.xlsx
2024-03-01,COMPRA CARTÃO - FERRY-BOAT GUARATUBA - ATEND. PANASONIC,,0.0,8.9,5678.81,INTER,Despesa com produtos,Fretes e Pedagios,../data/raw/BANCO INTER-2024.xlsx
2024-03-04,PIX RECEBIDO CRISTIANE FILGUEIRAS MACHARETH CASSIMIRO,,370.0,0.0,6048.81,INTER,Receita com serviços,Manutenção s/ Garantia,../data/raw/BANCO INTER-2024.xlsx
2024-03-04,PIX RECEBIDO JOSÉ RONALDO RIBEIRO,,370.0,0.0,6418.81,INTER,Receita com serviços,Manutenção s/ Garantia,../data/raw/BANCO INTER-2024.xlsx
2024-03-04,PIX RECEBIDO LUCIANA CAZULA OLIVEIRA,,480.0,0.0,6898.81,INTER,Receita com serviços,Manutenção s/ Garantia,../data/raw/BANCO INTER-2024.xlsx
2024-03-04,PIX ENVIADO GOVERNO DO PARANA SECRETARIA DE ESTADO - GRPR,,0.0,137.62,6761.19,INTER,Despesas tributárias ,Outras,../data/raw/BANCO INTER-2024.xlsx
2024-03-04,PIX ENVIADO NICOLAS F. CHRISTINO - ADIANTAMENTO DE SALÁRIO (VALE),,0.0,1000.0,5761.19,INTER,Despesa com pessoal,Salário,../data/raw/BANCO INTER-2024.xlsx
2024-03-05,PIX RECEBIDO MICHEL MOREIRA SANTOS,,695.0,0.0,6456.19,INTER,Receita com serviços,Manutenção s/ Garantia,../data/raw/BANCO INTER-2024.xlsx
2024-03-06,RESGATE - CDB CREDITO BANCO INTER AS,,2168.38,0.0,8624.57,INTER,Receitas financeiras,Outras,../data/raw/BANCO INTER-2024.xlsx
2024-03-06,PIX ENVIADO ADRIANA DOS SANTOS SEIXAS - PAGTO DE SALÁRIO,,0.0,238.63,8385.94,INTER,Despesa com pessoal,13º salário,../data/raw/BANCO INTER-2024.xlsx
2024-03-06,PIX ENVIADO SILVIA CRISTINA ARRUDA - HONORÁRIOS CONTABILIDADE,,0.0,848.45,7537.49,INTER,Despesas administrativas,Contabilidade,../data/raw/BANCO INTER-2024.xlsx
2024-03-06,PIX ENVIADO THIAGO IANUCH MARIN - PAGTO DE SALÁRIO,,0.0,1604.68,5932.81,INTER,Despesa com pessoal,Salário,../data/raw/BANCO INTER-2024.xlsx
2024-03-06,PIX RECEBIDO SHEILA DE FATIMA TREVISAN BETTANIN,,80.0,0.0,6012.81,INTER,Receita com serviços,Manutenção s/ Garantia,../data/raw/BANCO INTER-2024.xlsx
2024-03-06,COMPRA CARTÃO - FERRY-BOAT GUARATUBA - ATEND. PANASONIC,,0.0,8.9,6003.91,INTER,Despesa com produtos,Fretes e Pedagios,../data/raw/BANCO INTER-2024.xlsx
2024-03-07,COMPRA CARTÃO - PEDÁGIO,,0.0,4.9,5999.01,INTER,Despesa com produtos,Fretes e Pedagios,../data/raw/BANCO INTER-2024.xlsx
2024-03-07,COMPRA CARTÃO - PEDÁGIO,,0.0,4.9,5994.11,INTER,Despesa com produtos,Fretes e Pedagios,../data/raw/BANCO INTER-2024.xlsx
2024-03-07,COMPRA CARTÃO - RECARGA CELULAR,,0.0,15.0,5979.11,INTER,Despesas administrativas,"Telefonia (Celular, Fixo, Internet)",../data/raw/BANCO INTER-2024.xlsx
2024-03-07,ESTORNO COMPRA CARTÃO - RECARGA CELULAR,,15.0,0.0,5994.11,INTER,Outras entradas,Estorno de pagamento,../data/raw/BANCO INTER-2024.xlsx
2024-03-07,PIX RECEBIDO PAULO  RICARDO ZAVADIL,,385.0,0.0,6379.11,INTER,Receita com serviços,Manutenção s/ Garantia,../data/raw/BANCO INTER-2024.xlsx
2024-03-07,PAGAMENTO DE ALUGUEL,,0.0,4726.36,1652.75,INTER,Despesas administrativas,Aluguel imóvel,../data/raw/BANCO INTER-2024.xlsx
2024-03-08,PAGAMENTO CIEE - ESTAGIÁRIO,,0.0,500.19,1152.56,INTER,Despesa com pessoal,Salário,../data/raw/BANCO INTER-2024.xlsx
2024-03-08,PIX RECEBIDO LUIZ FERNANDO SOLHEID,,430.0,0.0,1582.56,INTER,Receita com serviços,Manutenção s/ Garantia,../data/raw/BANCO INTER-2024.xlsx
2024-03-11,PIX ENVIADO ECEELTEC CRED CREA,,0.0,420.0,1162.56,INTER,Transferência (Débito),Transferência entre contas,../data/raw/BANCO INTER-2024.xlsx
2024-03-11,PIX RECEBIDO CARLOS LINEU ZGODA KUZMA,,535.0,0.0,1697.56,INTER,Receita com serviços,Manutenção s/ Garantia,../data/raw/BANCO INTER-2024.xlsx
2024-03-12,PIX RECEBIDO ELISANGELA G B PAES IMOTO,,45.0,0.0,1742.56,INTER,Receita com serviços,Manutenção s/ Garantia,../data/raw/BANCO INTER-2024.xlsx
2024-03-12,PIX RECEBIDO ASSISTENCIA TÉCNICA DE ELETRODOMESTICOS MHL LTDA,,475.0,0.0,2217.56,INTER,Receita de vendas,Outras vendas,../data/raw/BANCO INTER-2024.xlsx
2024-03-12,PIX RECEBIDO FABIANO CARLOS DOS SANTOS,,450.0,0.0,2667.56,INTER,Receita com serviços,Manutenção s/ Garantia,../data/raw/BANCO INTER-2024.xlsx
2024-03-13,PIX RECEBIDO LUIZ TOSHIHARU HASHIGUCHI JUNIOR,,100.0,0.0,2767.56,INTER,Receita com serviços,Manutenção s/ Garantia,../data/raw/BANCO INTER-2024.xlsx
2024-03-13,PIX RECEBIDO MIRIAM APARECIDA SALOMÃO EASTWOOD POK,,385.0,0.0,3152.56,INTER,Receita com serviços,Manutenção s/ Garantia,../data/raw/BANCO INTER-2024.xlsx
2024-03-13,PIX RECEBIDO VALDIRENE MARQUES SILVA,,130.0,0.0,3282.56,INTER,Receita com serviços,Manutenção s/ Garantia,../data/raw/BANCO INTER-2024.xlsx
2024-03-13,PIX RECEBIDO JULIANA DE SOUSA MARQUES,,345.0,0.0,3627.56,INTER,Receita com serviços,Manutenção s/ Garantia,../data/raw/BANCO INTER-2024.xlsx
2024-03-14,PAGAMENTO BOLETO SPRINGER CARRIER,,0.0,1684.79,1942.77,INTER,Despesa com serviços,Peças,../data/raw/BANCO INTER-2024.xlsx
2024-03-18,COMPRA CARTÃO - FERRY-BOAT GUARATUBA - ATEND. PANASONIC,,0.0,8.9,1933.87,INTER,Despesa com produtos,Fretes e Pedagios,../data/raw/BANCO INTER-2024.xlsx
2024-03-18,PIX RECEBIDO MATHEUS APARECIDO SARTORI FERNANDES,,40.0,0.0,1973.87,INTER,Receita com serviços,Manutenção s/ Garantia,../data/raw/BANCO INTER-2024.xlsx
2024-03-18,PIX RECEBIDO ROGERIO LUIZ SOUZA DE CAMARGO,,580.0,0.0,2553.87,INTER,Receita com serviços,Manutenção s/ Garantia,../data/raw/BANCO INTER-2024.xlsx
2024-03-19,PIX RECEBIDO MAZINI ADVOGADOS ASSOCIADOS,,350.0,0.0,2903.87,INTER,Receita com serviços,Manutenção s/ Garantia,../data/raw/BANCO INTER-2024.xlsx
2024-03-19,PIX RECEBIDO GRAZIELLA STEIN PATRIAL,,55.0,0.0,2958.87,INTER,Receita com serviços,Manutenção s/ Garantia,../data/raw/BANCO INTER-2024.xlsx
2024-03-20,PIX RECEBIDO BRUNA SOUZA,,400.0,0.0,3358.87,INTER,Receita com serviços,Manutenção s/ Garantia,../data/raw/BANCO INTER-2024.xlsx
2024-03-20,PIX ENVIADO GOVERNO DO PARANA - IPVA/2024 RANGER - 3 DE 5,,0.0,975.61,2383.26,INTER,Despesas tributárias ,IPVA,../data/raw/BANCO INTER-2024.xlsx
2024-03-20,PIX ENVIADO ELISABETE - PAGTO PRO-LABORE,,0.0,1352.8,1030.46,INTER,Despesa com pessoal,Pró labore,../data/raw/BANCO INTER-2024.xlsx
2024-03-20,PIX RECEBIDO FABIANA LUIZA QUINTANILHA RONZANI CUN,,123.0,0.0,1153.46,INTER,Receita com serviços,Manutenção s/ Garantia,../data/raw/BANCO INTER-2024.xlsx
2024-03-21,PIX ENVIADO - VR BENEF SERV PROC AS ,,0.0,178.0,975.46,INTER,Despesa com pessoal,Alimentação (VR VA),../data/raw/BANCO INTER-2024.xlsx
2024-03-21,PIX RECEBIDO FRESNOMAQ INDUSTRIA DE MAQUINAS S/A NFS-e 2496,,1425.0,0.0,2400.46,INTER,Receita de vendas,Outras vendas,../data/raw/BANCO INTER-2024.xlsx
2024-03-21,PIX RECEBIDO FABIANA LUIZA QUINTANILHA RONZANI CUN,,122.0,0.0,2522.46,INTER,Receita com serviços,Manutenção s/ Garantia,../data/raw/BANCO INTER-2024.xlsx
2024-03-22,PIX RECEBIDO ELAINE KIMIKO TATEISHI,,75.0,0.0,2597.46,INTER,Receita com serviços,Manutenção s/ Garantia,../data/raw/BANCO INTER-2024.xlsx
2024-03-22,PIX RECEBIDO ANDERSON LUIS WAGNER,,90.0,0.0,2687.46,INTER,Receita com serviços,Manutenção s/ Garantia,../data/raw/BANCO INTER-2024.xlsx
2024-03-22,PIX RECEBIDO LETICIA REGINA VAZ,,460.0,0.0,3147.46,INTER,Receita com serviços,Manutenção s/ Garantia,../data/raw/BANCO INTER-2024.xlsx
2024-03-22,PIX ENVIADO GOVERNO DO PARANA - IPVA/2024 FIESTA - 2 DE 5,,0.0,126.61,3020.85,INTER,Despesas tributárias ,IPVA,../data/raw/BANCO INTER-2024.xlsx
2024-03-22,PIX ENVIADO GOVERNO DO PARANA - IPVA/2024 FIESTA - 3 DE 5,,0.0,113.85,2907,INTER,Despesas tributárias ,IPVA,../data/raw/BANCO INTER-2024.xlsx
2024-03-22,PIX RECEBIDO CHARLOTTE STOCK,,385.0,0.0,3292,INTER,Receita com serviços,Manutenção s/ Garantia,../data/raw/BANCO INTER-2024.xlsx
2024-03-23,PIX RECEBIDO PAGSEGURO INTERNET LTDA,,679.65,0.0,3971.65,INTER,Receita com serviços,Manutenção s/ Garantia,../data/raw/BANCO INTER-2024.xlsx
2024-03-25,PIX RECEBIDO RODRIGO RIBEIRO TOMAZ,,485.0,0.0,4456.65,INTER,Receita com serviços,Manutenção s/ Garantia,../data/raw/BANCO INTER-2024.xlsx
2024-03-26,PIX ENVIADO ASSOCIACAO METROCARD - VT RONALDO,,0.0,121.9,4334.75,INTER,Despesa com pessoal,Transporte (VT),../data/raw/BANCO INTER-2024.xlsx
2024-03-26,PAGTO VALE TRANSPORTE URBS - ,,0.0,663.03,3671.72,INTER,Despesa com pessoal,Transporte (VT),../data/raw/BANCO INTER-2024.xlsx
2024-03-26,PIX RECEBIDO JOSE VINICIUS ALVES FERREIRA,,310.0,0.0,3981.72,INTER,Receita com serviços,Manutenção s/ Garantia,../data/raw/BANCO INTER-2024.xlsx
2024-03-28,PIX RECEBIDO ELOI RODRIGUES DA COSTA,,520.0,0.0,4501.72,INTER,Receita com serviços,Manutenção s/ Garantia,../data/raw/BANCO INTER-2024.xlsx
2024-03-28,PIX ENVIADO KAIO SPURI LIMA - PAGTO DE VALE TRANSPORTE ESTAGIÁRIO,,0.0,264.0,4237.72,INTER,Despesa com pessoal,Transporte (VT),../data/raw/BANCO INTER-2024.xlsx
2024-03-28,PIX ENVIADO LUIZ - PAGTO DE SERVIÇOS,,0.0,200.0,4037.72,INTER,Despesa com serviços,Mão de obra,../data/raw/BANCO INTER-2024.xlsx
2024-03-28,PIX ENVIADO SIMONE P PAGTO TERCEIRO,,0.0,1000.0,3037.72,INTER,Despesa com serviços,Mão de obra,../data/raw/BANCO INTER-2024.xlsx
2024-03-28,PIX RECEBIDO JACKSON LUIZ ANTUNES,,1090.0,0.0,4127.72,INTER,Receita com serviços,Manutenção s/ Garantia,../data/raw/BANCO INTER-2024.xlsx
2024-03-28,COMPRA CARTÃO - FERRY-BOAT GUARATUBA - ATEND. PANASONIC,,0.0,8.9,4118.82,INTER,Despesa com produtos,Fretes e Pedagios,../data/raw/BANCO INTER-2024.xlsx
2024-04-01,PIX RECEBIDO JEFFERSON KRUGER ROCHA,,350.0,0.0,4468.82,INTER,Receita com serviços,Manutenção s/ Garantia,../data/raw/BANCO INTER-2024.xlsx
2024-04-02,PIX RECEBIDO ELDREY SEOLIN GALINDO,,1000.0,0.0,5468.82,INTER,Receita de vendas,Outras vendas,../data/raw/BANCO INTER-2024.xlsx
2024-04-02,PIX RECEBIDO VALERIA DE OLIVEIRA BOENO DA SILVA,,80.0,0.0,5548.82,INTER,Receita com serviços,Manutenção s/ Garantia,../data/raw/BANCO INTER-2024.xlsx
2024-04-02,PIX RECEBIDO PAGSEGURO INTERNET LTDA,,410.55,0.0,5959.37,INTER,Receita com serviços,Manutenção s/ Garantia,../data/raw/BANCO INTER-2024.xlsx
2024-04-02,PIX RECEBIDO KAILON SOHN,,40.0,0.0,5999.37,INTER,Receita com serviços,Manutenção s/ Garantia,../data/raw/BANCO INTER-2024.xlsx
2024-04-03,PIX RECEBIDO JEFFERSON BUENO MENDES,,1123.75,0.0,7123.12,INTER,Receita de vendas,Outras vendas,../data/raw/BANCO INTER-2024.xlsx
2024-04-03,PIX RECEBIDO LEILA CRISTINA BIANCHI DE ANDRADE,,2850.0,0.0,9973.12,INTER,Receita de vendas,Outras vendas,../data/raw/BANCO INTER-2024.xlsx
2024-04-03,PIX ENVIADO GOVERNO DO PARANA SECRETARIA DE ESTADO - GRPR,,0.0,703.96,9269.16,INTER,Despesas tributárias ,Outras,../data/raw/BANCO INTER-2024.xlsx
2024-04-03,PIX RECEBIDO KATIANY BRUN,,800.0,0.0,10069.16,INTER,Receita com serviços,Manutenção s/ Garantia,../data/raw/BANCO INTER-2024.xlsx
2024-04-04,PIX RECEBIDO JOAO HENRIQUE TOSIN,,350.0,0.0,10419.16,INTER,Receita com serviços,Manutenção s/ Garantia,../data/raw/BANCO INTER-2024.xlsx
2024-04-04,PIX RECEBIDO JULIANO KAZUO TAMIYA FO,,70.0,0.0,10489.16,INTER,Receita com serviços,Manutenção s/ Garantia,../data/raw/BANCO INTER-2024.xlsx
2024-04-05,PIX RECEBIDO GUSTAVO BARMANN,,40.0,0.0,10529.16,INTER,Receita com serviços,Manutenção s/ Garantia,../data/raw/BANCO INTER-2024.xlsx
2024-04-05,PIX ENVIADO-RONALDO FIRMINO DE FARIAS - PAGTO DE SALÁRIO,,0.0,1569.37,8959.79,INTER,Despesa com pessoal,Salário,../data/raw/BANCO INTER-2024.xlsx
2024-04-05,PIX ENVIADO-ADRIANA DOS SANTOS SEIXAS - PAGTO DE SALÁRIO,,1688.76,0.0,7271.03,INTER,Despesa com pessoal,Salário,../data/raw/BANCO INTER-2024.xlsx
2024-04-05,PIX ENVIADO-NICOLAS FALAVINHA CHRISTINO - PAGTO DE SALÁRIO,,0.0,1508.99,5762.04,INTER,Despesa com pessoal,Salário,../data/raw/BANCO INTER-2024.xlsx
2024-04-05,PIX ENVIADO-THIAGO IANUCH MARIN - PAGTO DE SALÁRIO,,0.0,1681.63,4080.41,INTER,Despesa com pessoal,Salário,../data/raw/BANCO INTER-2024.xlsx
2024-04-05,PIX ENVIADO-SILVIA CRISTINA ARRUDA - CONTABILIDADE PAGTO DE HONORÁRIOS,,0.0,559.45,3520.96,INTER,Despesas administrativas,Contabilidade,../data/raw/BANCO INTER-2024.xlsx
2024-04-05,PIX ENVIADO-LUIZ GUILHERME KRAUSE - PAGTO DE SALÁRIO,,0.0,1543.56,1977.4,INTER,Despesa com pessoal,Salário,../data/raw/BANCO INTER-2024.xlsx
2024-04-05,PIX RECEBIDO PAGSEGURO INTERNET LTDA,,2657.78,0.0,4635.18,INTER,Receita com serviços,Manutenção s/ Garantia,../data/raw/BANCO INTER-2024.xlsx
2024-04-05,PIX RECEBIDO FRANCISCO SPITZNER NETO,,465.0,0.0,5100.18,INTER,Receita com serviços,Manutenção s/ Garantia,../data/raw/BANCO INTER-2024.xlsx
2024-04-08,PIX RECEBIDO AFIZA ZENEDIN KONDO,,465.0,0.0,5565.18,INTER,Receita com serviços,Manutenção s/ Garantia,../data/raw/BANCO INTER-2024.xlsx
2024-04-08,PAGAMENTO DE ALUGUEL,,0.0,4726.36,838.82,INTER,Despesas administrativas,Aluguel imóvel,../data/raw/BANCO INTER-2024.xlsx
2024-04-08,PIX RECEBIDO ANA WINTER,,135.0,0.0,973.82,INTER,Receita com serviços,Manutenção s/ Garantia,../data/raw/BANCO INTER-2024.xlsx
2024-04-08,PIX RECEBIDO JOÃO JORGE SANTIAGO ANTUNES,,135.0,0.0,1108.82,INTER,Receita com serviços,Manutenção s/ Garantia,../data/raw/BANCO INTER-2024.xlsx
2024-04-08,PIX RECEBIDO DJALMA ROCHA A C M PEREIRA,,330.0,0.0,1438.82,INTER,Receita com serviços,Manutenção s/ Garantia,../data/raw/BANCO INTER-2024.xlsx
2024-04-10,PIX RECEBIDO SERGIO ANTONIO MARQUES,,145.0,0.0,1583.82,INTER,Receita com serviços,Manutenção s/ Garantia,../data/raw/BANCO INTER-2024.xlsx
2024-04-10,PIX RECEBIDO ZENIR PEREIRA DA SILVA,,90.0,0.0,1673.82,INTER,Receita com serviços,Manutenção s/ Garantia,../data/raw/BANCO INTER-2024.xlsx
2024-04-10,PIX ENVIADO ECEELTEC - BANCO CRED CREA,,0.0,100.0,1573.82,INTER,Transferência (Débito),Transferência entre contas,../data/raw/BANCO INTER-2024.xlsx
2024-04-10,PIX RECEBIDO NICOLE DO AMARAL PRESENDO,,40.0,0.0,1613.82,INTER,Receita com serviços,Manutenção s/ Garantia,../data/raw/BANCO INTER-2024.xlsx
2024-04-10,PIX RECEBIDO MAXIMILIANO RIBEIRO BORTOLATO,,300.0,0.0,1913.82,INTER,Receita com serviços,Manutenção s/ Garantia,../data/raw/BANCO INTER-2024.xlsx
2024-04-10,PIX RECEBIDO MARCOS VIEIRA,,500.0,0.0,2413.82,INTER,Receita com serviços,Manutenção s/ Garantia,../data/raw/BANCO INTER-2024.xlsx
2024-04-10,PIX RECEBIDO JEAN CARMONA DE FIGUEIREDO NEGRÃO,,550.0,0.0,2963.82,INTER,Receita com serviços,Manutenção s/ Garantia,../data/raw/BANCO INTER-2024.xlsx
2024-04-11,PIX ENVIADO PORTOSEG - PEDÁGIOS,,0.0,92.71,2871.11,INTER,Despesa com produtos,Fretes e Pedagios,../data/raw/BANCO INTER-2024.xlsx
2024-04-11,PAGAMENTO BOLETO WHITE MARTINS,,0.0,49.39,2821.72,INTER,Despesa com produtos,Materiais de Consumo,../data/raw/BANCO INTER-2024.xlsx
2024-04-15,PIX ENVIADO CLAUDIO - PAGTO PRO-LABORE REF. À FEVEREIRO C/ VENC EM MARÇO,,0.0,1352.8,1468.92,INTER,Despesa com pessoal,Pró labore,../data/raw/BANCO INTER-2024.xlsx
2024-04-15,PIX RECEBIDO JUSSARA TURIM POLITANO,,700.0,0.0,2168.92,INTER,Receita com serviços,Manutenção s/ Garantia,../data/raw/BANCO INTER-2024.xlsx
2024-04-16,PIX RECEBIDO GUILHERME PINHEIRO DIAS,,1650.0,0.0,3818.92,INTER,Receita com serviços,Manutenção s/ Garantia,../data/raw/BANCO INTER-2024.xlsx
2024-04-17,PIX RECEBIDO SERGIO ANTONIO MARQUES,,90.0,0.0,3908.92,INTER,Receita com serviços,Manutenção s/ Garantia,../data/raw/BANCO INTER-2024.xlsx
2024-04-17,PIX RECEBIDO DANIEL BAPTISTA PIRES BITTAR,,550.0,0.0,4458.92,INTER,Receita com serviços,Manutenção s/ Garantia,../data/raw/BANCO INTER-2024.xlsx
2024-04-18,PIX RECEBIDO BEATRIZ MARIA DOS SANTOS,,65.0,0.0,4520.92,INTER,Receita com serviços,Manutenção s/ Garantia,../data/raw/BANCO INTER-2024.xlsx
2024-04-18,PIX RECEBIDO JULIANA RODRIGUES DA SILVA,,2190.0,0.0,6710.92,INTER,Receita com serviços,Manutenção s/ Garantia,../data/raw/BANCO INTER-2024.xlsx
2024-04-18,COMPRA CARTÃO ARMAZÉM DO AÇO NF 11975,,0.0,215.0,6498.92,INTER,Despesas administrativas,Manutenção predial,../data/raw/BANCO INTER-2024.xlsx
2024-04-19,PIX RECEBIDO LORDS004 ALUGUEL DE TRAJES LTDA,,600.0,0.0,7098.92,INTER,Outras entradas,Outras,../data/raw/BANCO INTER-2024.xlsx
2024-04-19,PIX ENVIADO - PAGTO FGTS,,0.0,1045.22,6053.7,INTER,Despesa com pessoal,FGTS,../data/raw/BANCO INTER-2024.xlsx
2024-04-19,PIX ENVIADO GOVERNO DO PARANA - IPVA/2024 RANGER - 4 DE 5,,0.0,975.61,5078.09,INTER,Despesas tributárias ,IPVA,../data/raw/BANCO INTER-2024.xlsx
2024-04-19,PIX ENVIADO PAGTO CARTÃO INTER,,0.0,4327.04,751.05,INTER,Transferência (Crédito),Aplicação,../data/raw/BANCO INTER-2024.xlsx
2024-04-19,COMPRA CARTÃO  - FERRY-BOAT GUARATUBA - ATEND. PANASONIC,,0.0,8.9,742.15,INTER,Despesa com produtos,Fretes e Pedagios,../data/raw/BANCO INTER-2024.xlsx
2024-04-19,COMPRA CARTÃO  - FERRY-BOAT GUARATUBA - ATEND. PANASONIC,,0.0,8.9,733.25,INTER,Despesa com produtos,Fretes e Pedagios,../data/raw/BANCO INTER-2024.xlsx
2024-04-20,PIX RECEBIDO LEONARDO ROBERTO FERREIRA,,575.0,0.0,1308.25,INTER,Receita com serviços,Manutenção s/ Garantia,../data/raw/BANCO INTER-2024.xlsx
2024-04-22,PIX RECEBIDO Rhayane Radomski,,395.0,0.0,1703.25,INTER,Receita com serviços,Manutenção s/ Garantia,../data/raw/BANCO INTER-2024.xlsx
2024-04-22,PIX ENVIADO JULIANA RODRIGUES DA SILVA -DEVOLUÇÃO  PARCIAL DE COMPRA DIA 18/04,,0.0,1500.0,203.25,INTER,Despesa com produtos,Outras,../data/raw/BANCO INTER-2024.xlsx
2024-04-23,PIX RECEBIDO GABRIEL JOSE MALLMANN,,600.0,0.0,803.25,INTER,Receita com serviços,Manutenção s/ Garantia,../data/raw/BANCO INTER-2024.xlsx
2024-04-23,PIX ENVIADO AKITA COMERCIO DE PECAS LTDA,,0.0,16.1,787.15,INTER,Despesa com serviços,Peças,../data/raw/BANCO INTER-2024.xlsx
2024-04-23,PIX RECEBIDO MARCIUS VIANA E SILVA,,380.0,0.0,1167.15,INTER,Receita com serviços,Manutenção s/ Garantia,../data/raw/BANCO INTER-2024.xlsx
2024-04-23,PIX ENVIADO GOVERNO DO PARANA - IPVA/2024 FIESTA - 4 DE 5,,0.0,113.85,1053.3,INTER,Despesas tributárias ,IPVA,../data/raw/BANCO INTER-2024.xlsx
2024-04-24,PIX RECEBIDO EMANUELE AMANDA MARQUES,,400.0,0.0,1453.3,INTER,Receita com serviços,Manutenção s/ Garantia,../data/raw/BANCO INTER-2024.xlsx
2024-04-24,PIX ENVIADO LUIZ - LANCHE REFERENTE HORAS EXTRAS,,0.0,60.0,1393.3,INTER,Despesa com pessoal,Alimentação (VR VA),../data/raw/BANCO INTER-2024.xlsx
2024-04-25,PIX RECEBIDO ALEXANDRE OSMAR SOETHE,,240.0,0.0,1633.3,INTER,Receita com serviços,Manutenção s/ Garantia,../data/raw/BANCO INTER-2024.xlsx
2024-04-25,PIX RECEBIDO LUIZ CARLOS FABRIS,,450.0,0.0,2083.3,INTER,Receita com serviços,Manutenção s/ Garantia,../data/raw/BANCO INTER-2024.xlsx
2024-04-25,PIX RECEBIDO RODOLFO KAELIN FIORDERIZE,,490.0,0.0,2573.3,INTER,Receita com serviços,Manutenção s/ Garantia,../data/raw/BANCO INTER-2024.xlsx
2024-04-25,PIX RECEBIDO LAURA MAR HAID BOL CASTRO LAGO,,780.0,0.0,3353.3,INTER,Receita com serviços,Manutenção s/ Garantia,../data/raw/BANCO INTER-2024.xlsx
2024-04-26,PIX RECEBIDO MODERNITY JOIAS LTDA ME,,495.0,0.0,3848.3,INTER,Receita com serviços,Manutenção s/ Garantia,../data/raw/BANCO INTER-2024.xlsx
2024-04-27,COMPRA CARTÃO  - FERRY-BOAT GUARATUBA - ATEND. PANASONIC,,0.0,8.9,3839.4,INTER,Despesa com produtos,Fretes e Pedagios,../data/raw/BANCO INTER-2024.xlsx
2024-04-28,PIX RECEBIDO PAGSEGURO INTERNET LTDA,,613.41,0.0,4452.81,INTER,Receita com serviços,Manutenção s/ Garantia,../data/raw/BANCO INTER-2024.xlsx
2024-04-28,PIX ENVIADO EDRIC - REEMBOLSO DE ALIMENTAÇÃO,,0.0,53.99,4398.82,INTER,Despesa com pessoal,Alimentação (VR VA),../data/raw/BANCO INTER-2024.xlsx
2024-04-29,PIX RECEBIDO LUIZ TOSHIHARU HASHIGUCHI JUNIOR,,100.0,0.0,4498.82,INTER,Receita com serviços,Manutenção s/ Garantia,../data/raw/BANCO INTER-2024.xlsx
2024-04-29,PIX ENVIADO ASSOCIACAO METROCARD - VT RONALDO,,0.0,110.9,4387.92,INTER,Despesa com pessoal,Transporte (VT),../data/raw/BANCO INTER-2024.xlsx
2024-04-29,PIX RECEBIDO MARLI TERESINHA DOS S CAMARGO,,380.0,0.0,4767.92,INTER,Receita com serviços,Manutenção s/ Garantia,../data/raw/BANCO INTER-2024.xlsx
2024-04-29,PIX RECEBIDO LEONARDO ROBERTO FERREIRA,,407.0,0.0,5174.92,INTER,Receita com serviços,Manutenção s/ Garantia,../data/raw/BANCO INTER-2024.xlsx
2024-04-30,PIX RECEBIDO FELIPE ANSELMO REIS,,530.0,0.0,5704.92,INTER,Receita com serviços,Manutenção s/ Garantia,../data/raw/BANCO INTER-2024.xlsx
2024-04-30,PIX ENVIADO KAIO SPURI LIMA - PAGTO DE VALE TRANSPORTE ESTAGIÁRIO,,0.0,240.0,5464.92,INTER,Despesa com pessoal,Transporte (VT),../data/raw/BANCO INTER-2024.xlsx
2024-05-02,PIX RECEBIDO TASLA MESSANY,,40.0,0.0,5504.92,INTER,Receita com serviços,Manutenção s/ Garantia,../data/raw/BANCO INTER-2024.xlsx
2024-05-02,PIX RECEBIDO MARIA PAULA RAMOS DE COSTANTINI,,250.0,0.0,5754.92,INTER,Receita com serviços,Manutenção s/ Garantia,../data/raw/BANCO INTER-2024.xlsx
2024-05-02,PIX RECEBIDO ALESSANDRA APARECIDA COSTA BRAGUETO,,390.0,0.0,6144.92,INTER,Receita com serviços,Manutenção s/ Garantia,../data/raw/BANCO INTER-2024.xlsx
2024-05-02,PIX RECEBIDO PAGSEGURO INTERNET LTDA,,618.24,0.0,6763.16,INTER,Receita com serviços,Manutenção s/ Garantia,../data/raw/BANCO INTER-2024.xlsx
2024-05-03,PIX RECEBIDO ALEXANDRE OSMAR SOETHE,,275.0,0.0,7038.16,INTER,Receita com serviços,Manutenção s/ Garantia,../data/raw/BANCO INTER-2024.xlsx
2024-05-03,PIX RECEBIDO PAGSEGURO INTERNET LTDA,,627.9,0.0,7999.06,INTER,Receita com serviços,Manutenção s/ Garantia,../data/raw/BANCO INTER-2024.xlsx
2024-05-03,PIX RECEBIDO WELTON CASSERO PEREIRA,,450.0,0.0,8116.06,INTER,Receita com serviços,Manutenção s/ Garantia,../data/raw/BANCO INTER-2024.xlsx
2024-05-03,PIX ENVIADO GOVERNO DO PARANA SECRETARIA DE ESTADO - GRPR,,0.0,9.37,8106.69,INTER,Despesas tributárias ,Outras,../data/raw/BANCO INTER-2024.xlsx
2024-05-06,PIX RECEBIDO BRUNA CAROLINA GAMA DA MOTA,,135.0,0.0,8241.69,INTER,Receita com serviços,Manutenção s/ Garantia,../data/raw/BANCO INTER-2024.xlsx
2024-05-06,PIX RECEBIDO EDERALDO LUIZ PRESTES,,950.0,0.0,9191.69,INTER,Receita com serviços,Manutenção s/ Garantia,../data/raw/BANCO INTER-2024.xlsx
2024-05-07,PIX RECEBIDO PEDRO HENRIQUE WEIDLEW,,2810.0,0.0,12001.69,INTER,Receita de vendas,Outras vendas,../data/raw/BANCO INTER-2024.xlsx
2024-05-07,PIX RECEBIDO ANA LUISA M MASSET LACOMBE,,110.0,0.0,12111.69,INTER,Receita com serviços,Manutenção s/ Garantia,../data/raw/BANCO INTER-2024.xlsx
2024-05-07,PIX ENVIADO ADRIANA DOS SANTOS SEIXAS - PAGAMENTO DE SALARIO,,0.0,1690.05,10421.64,INTER,Despesa com pessoal,13º salário,../data/raw/BANCO INTER-2024.xlsx
2024-05-07,PIX ENVIADO NICOLAS FALAVINHA CHRISTINO - PAGAMENTO DE SALARIO,,0.0,1494.06,8927.58,INTER,Despesa com pessoal,Salário,../data/raw/BANCO INTER-2024.xlsx
2024-05-07,PIX ENVIADO RONALDO FIRMINO DE FARIAS - PAGAMENTO DE SALARIO,,0.0,1498.59,7428.99,INTER,Despesa com pessoal,Salário,../data/raw/BANCO INTER-2024.xlsx
2024-05-07,PIX ENVIADO THIAGO IANUCH MARIN - PAGAMENTO DE SALARIO,,0.0,1681.63,5747.36,INTER,Despesa com pessoal,Salário,../data/raw/BANCO INTER-2024.xlsx
2024-05-07,PIX RECEBIDO JOAO GUALBERTO PINHEIRO JUNIOR,,180.0,0.0,5927.36,INTER,Receita com serviços,Manutenção s/ Garantia,../data/raw/BANCO INTER-2024.xlsx
2024-05-07,PIX RECEBIDO SIBELE DE SOUZA E SILVA,,500.0,0.0,6427.36,INTER,Receita com serviços,Manutenção s/ Garantia,../data/raw/BANCO INTER-2024.xlsx
2024-05-08,PIX RECEBIDO -MARIA APARECIDA DA SILVA,,665.0,0.0,7092.36,INTER,Receita com serviços,Manutenção s/ Garantia,../data/raw/BANCO INTER-2024.xlsx
2024-05-09,PIX RECEBIDO JEFFERSON BUENO MENDES,,180.0,0.0,7272.36,INTER,Receita com serviços,Manutenção s/ Garantia,../data/raw/BANCO INTER-2024.xlsx
2024-05-09,PIX RECEBIDO REFRIGERACAO SAO JOSE LTDA,,75.0,0.0,7347.36,INTER,Receita de vendas,Outras vendas,../data/raw/BANCO INTER-2024.xlsx
2024-05-10,PIX RECEBIDO ANA LUISA M MASSET LACOMBE,,110.0,0.0,7457.36,INTER,Receita com serviços,Manutenção s/ Garantia,../data/raw/BANCO INTER-2024.xlsx
2024-05-10,PAGAMENTO DE ALUGUEL,,0.0,4993.82,2463.54,INTER,Despesas administrativas,Aluguel imóvel,../data/raw/BANCO INTER-2024.xlsx
2024-05-10,PIX RECEBIDO CHRISTOPHE ALLAIN,,690.0,0.0,3153.54,INTER,Receita com serviços,Manutenção s/ Garantia,../data/raw/BANCO INTER-2024.xlsx
2024-05-12,PIX ENVIADO PORTOSEG SA CREDITO FIN E INV (PEDÁGIOS),,0.0,152.4,3001.14,INTER,Despesa com produtos,Fretes e Pedagios,../data/raw/BANCO INTER-2024.xlsx
2024-05-13,PIX RECEBIDO LILIANE TATSUE HIGA,,400.0,0.0,3401.14,INTER,Receita com serviços,Manutenção s/ Garantia,../data/raw/BANCO INTER-2024.xlsx
2024-05-14,PIX RECEBIDO JOAO VICTOR MACHADO CRUZ,,280.0,0.0,3681.14,INTER,Receita de vendas,Outras vendas,../data/raw/BANCO INTER-2024.xlsx
2024-05-14,PIX RECEBIDO LILIANE TATSUE HIGA,,350.0,0.0,4031.14,INTER,Receita com serviços,Manutenção s/ Garantia,../data/raw/BANCO INTER-2024.xlsx
2024-05-14,PIX RECEBIDO PAULO HUMBERTO KASTRUP,,300.0,0.0,4331.14,INTER,Receita com serviços,Manutenção s/ Garantia,../data/raw/BANCO INTER-2024.xlsx
2024-05-14,PIX RECEBIDO GIOVANI PEREIRA,,360.0,0.0,4691.14,INTER,Receita com serviços,Manutenção s/ Garantia,../data/raw/BANCO INTER-2024.xlsx
2024-05-15,PIX RECEBIDO JOSÉ ROBERTO VIEIRA SIEWERDT,,400.0,0.0,5091.14,INTER,Receita com serviços,Manutenção s/ Garantia,../data/raw/BANCO INTER-2024.xlsx
2024-05-16,PIX RECEBIDO ANA CLAUDIA PEREIRA,,380.0,0.0,5471.14,INTER,Receita com serviços,Manutenção s/ Garantia,../data/raw/BANCO INTER-2024.xlsx
2024-05-17,PIX RECEBIDO ANDRE LUCIO PUPPI,,370.0,0.0,5841.14,INTER,Receita com serviços,Manutenção s/ Garantia,../data/raw/BANCO INTER-2024.xlsx
2024-05-17,PIX RECEBIDO EDSON JOSE PIRES,,300.0,0.0,6141.14,INTER,Receita de vendas,Outras vendas,../data/raw/BANCO INTER-2024.xlsx
2024-05-20,PIX RECEBIDO DANIELA REBELLO DE SOUZA,,135.0,0.0,6276.14,INTER,Receita de vendas,Outras vendas,../data/raw/BANCO INTER-2024.xlsx
2024-05-20,PIX RECEBIDO ANA CLAUDIA PEREIRA,,50.0,0.0,6326.14,INTER,Receita com serviços,Manutenção s/ Garantia,../data/raw/BANCO INTER-2024.xlsx
2024-05-20,PIX RECEBIDO FABIANO DOS SANTOS,,495.0,0.0,6821.14,INTER,Receita com serviços,Manutenção s/ Garantia,../data/raw/BANCO INTER-2024.xlsx
2024-05-20,PIX ENVIADO PAGTO CARTÃO INTER,,0.0,3086.28,3734.86,INTER,Transferência (Crédito),Aplicação,../data/raw/BANCO INTER-2024.xlsx
2024-05-22,PIX RECEBIDO ELETRO BARROS LTDA ME,,3500.0,0.0,7234.86,INTER,Receita de vendas,Outras vendas,../data/raw/BANCO INTER-2024.xlsx
2024-05-23,PIX RECEBIDO CONDOMINIO ED PETROPOLIS,,380.0,0.0,7614.86,INTER,Receita com serviços,Manutenção s/ Garantia,../data/raw/BANCO INTER-2024.xlsx
2024-05-23,PIX ENVIADO PIZZARIA DO JUNIOR EIRELI - ATENDIMETO PANASONIC,,0.0,53.99,7560.87,INTER,Despesa com serviços,Outras,../data/raw/BANCO INTER-2024.xlsx
2024-05-24,PIX RECEBIDO FRANCISCO DAS C L BARRETO,,480.0,0.0,8040.87,INTER,Receita com serviços,Manutenção s/ Garantia,../data/raw/BANCO INTER-2024.xlsx
2024-05-27,PIX RECEBIDO LARISSA ALCANTARA PEREIRA,,610.0,0.0,8650.87,INTER,Receita com serviços,Manutenção s/ Garantia,../data/raw/BANCO INTER-2024.xlsx
2024-05-27,PIX ENVIADO METROCARD - VT RONALDO,,0.0,110.9,8539.97,INTER,Despesa com pessoal,Transporte (VT),../data/raw/BANCO INTER-2024.xlsx
2024-05-28,PIX RECEBIDO CINTIA ARAI MENEGHETTI,,440.0,0.0,8979.97,INTER,Receita com serviços,Manutenção s/ Garantia,../data/raw/BANCO INTER-2024.xlsx
2024-05-28,PIX RECEBIDO ROGERIO LUIZ SOUZA DE CAMARGO,,192.5,0.0,9172.47,INTER,Receita com serviços,Manutenção s/ Garantia,../data/raw/BANCO INTER-2024.xlsx
2024-05-29,PIX RECEBIDO ANTONIO CARLOS ROCHA TEIXEIRA ALEXANDRE JUNIOR,,135.0,0.0,9307.47,INTER,Receita com serviços,Manutenção s/ Garantia,../data/raw/BANCO INTER-2024.xlsx
2024-05-29,PIX RECEBIDO FABIO POSSAGNO,,400.0,0.0,9707.47,INTER,Receita com serviços,Manutenção s/ Garantia,../data/raw/BANCO INTER-2024.xlsx
2024-05-31,PIX ENVIADO ADRIANA DOS S. SEIXAS -PAGTO RESCISÃO DO CONTRATO DE TRABALHO,,0.0,2611.85,7095.62,INTER,Despesa com pessoal,Aviso prévio / Multa rescisória,../data/raw/BANCO INTER-2024.xlsx
2024-06-03,PIX RECEBIDO HELOANE SANTOS ROSA SOZZI,,450.0,0.0,7545.62,INTER,Receita com serviços,Manutenção s/ Garantia,../data/raw/BANCO INTER-2024.xlsx
2024-06-05,PIX RECEBIDO ANA LUIZA HOMEM DEL REI,,1260.0,0.0,8805.62,INTER,Receita com serviços,Manutenção s/ Garantia,../data/raw/BANCO INTER-2024.xlsx
2024-06-05,PIX RECEBIDO CAIO FELIPE VIEIRA,,180.0,0.0,8985.62,INTER,Receita com serviços,Manutenção s/ Garantia,../data/raw/BANCO INTER-2024.xlsx
2024-06-06,PIX ENVIADO THIAGO - PAGTO DE SALÁRIO,,0.0,1651.63,7333.99,INTER,Despesa com pessoal,Salário,../data/raw/BANCO INTER-2024.xlsx
2024-06-06,PIX ENVIADO PORTOSEG SA CREDITO FIN E INV (PEDÁGIOS),,0.0,177.99,7156,INTER,Despesa com produtos,Fretes e Pedagios,../data/raw/BANCO INTER-2024.xlsx
2024-06-07,PIX RECEBIDO LUCIANA FERRER CARVALHO,,220.0,0.0,7376,INTER,Receita com serviços,Manutenção s/ Garantia,../data/raw/BANCO INTER-2024.xlsx
2024-06-07,PIX RECEBIDO BRUNA DAIANE RECH LUCCHESI,,160.0,0.0,7536,INTER,Receita de vendas,Outras vendas,../data/raw/BANCO INTER-2024.xlsx
2024-06-07,PIX RECEBIDO DORIANNE G ALVES SOUZA,,50.0,0.0,7586,INTER,Receita com serviços,Manutenção s/ Garantia,../data/raw/BANCO INTER-2024.xlsx
2024-06-07,PIX RECEBIDO RODRIGO HENRIQUE DE GOES,,430.0,0.0,8016,INTER,Receita com serviços,Manutenção s/ Garantia,../data/raw/BANCO INTER-2024.xlsx
2024-06-10,PIX RECEBIDO ANA CLAUDIA PANNEK,,465.0,0.0,8481,INTER,Receita com serviços,Manutenção s/ Garantia,../data/raw/BANCO INTER-2024.xlsx
2024-06-10,PIX RECEBIDO NOVA SUPER LIDER COMERCIO A. LTDA,,2280.0,0.0,10761,INTER,Receita com serviços,Manutenção s/ Garantia,../data/raw/BANCO INTER-2024.xlsx
2024-06-10,PIX RECEBIDO MARIA APARECIDA FERNANDES DE SOUZA,,185.0,0.0,10946,INTER,Receita com serviços,Manutenção s/ Garantia,../data/raw/BANCO INTER-2024.xlsx
2024-06-11,PIX RECEBIDO MARCO ANTONIO BASTOS SOLE,,40.0,0.0,10986,INTER,Receita com serviços,Manutenção s/ Garantia,../data/raw/BANCO INTER-2024.xlsx
2024-06-12,PIX RECEBIDO JURATRIZ SALETE RIBAS,,40.0,0.0,11026,INTER,Receita com serviços,Manutenção s/ Garantia,../data/raw/BANCO INTER-2024.xlsx
2024-06-13,PIX RECEBIDO SAVAGES COMERCIO DE PECAS PARA MOTOS,,385.0,0.0,11411,INTER,Receita com serviços,Manutenção s/ Garantia,../data/raw/BANCO INTER-2024.xlsx
2024-06-13,PIX RECEBIDO MULTI TRANSPORTES LTDA - NFS-e 2542 E NF-e 4561,,1680.0,0.0,13091,INTER,Receita com serviços,Manutenção s/ Garantia,../data/raw/BANCO INTER-2024.xlsx
2024-06-13,PIX RECEBIDO  ANA FLAVIA DA SILVA FAVERO ,,450.0,0.0,13541,INTER,Receita com serviços,Manutenção s/ Garantia,../data/raw/BANCO INTER-2024.xlsx
2024-06-14,COMPRA CARTÃO - VILA IZABEL MATERIAL DE CONSTRUÇÃO ,,0.0,37.0,13504,INTER,Despesas administrativas,Manutenção predial,../data/raw/BANCO INTER-2024.xlsx
2024-06-14,PIX ENVIADO CLAUDIO - PAGTO DE PRO-LABORE,,0.0,1352.8,12151.2,INTER,Despesa com pessoal,Pró labore,../data/raw/BANCO INTER-2024.xlsx
2024-06-14,PIX ENVIADO ELISABETE - PAGTO DE PRO-LABORE,,0.0,1352.8,10798.4,INTER,Despesa com pessoal,Pró labore,../data/raw/BANCO INTER-2024.xlsx
2024-06-17,PIX RECEBIDO LK2 PRODUCOES E EVENTOS LTDA,,415.0,0.0,11213.4,INTER,Receita com serviços,Manutenção s/ Garantia,../data/raw/BANCO INTER-2024.xlsx
2024-06-18,PIX RECEBIDO CRISTIANO SIMIONATO,,545.0,0.0,11758.4,INTER,Receita com serviços,Manutenção s/ Garantia,../data/raw/BANCO INTER-2024.xlsx
2024-06-18,PIX RECEBIDO DIRLENE DICKEL,,100.0,0.0,11858.4,INTER,Receita com serviços,Manutenção s/ Garantia,../data/raw/BANCO INTER-2024.xlsx
2024-06-19,PIX ENVIADO PAULO HUMBERTO KASTRUP - DEV. PAGTO RECEBIDO EM 14/05/24,,0.0,300.0,11558.4,INTER,Despesa com serviços,Outras,../data/raw/BANCO INTER-2024.xlsx
2024-06-19,PIX RECEBIDO ISABELA CESCHIN CELJAR,,180.0,0.0,11738.4,INTER,Receita com serviços,Manutenção s/ Garantia,../data/raw/BANCO INTER-2024.xlsx
2024-06-19,PAGTO BOLETO - SOLUÇÃO CERTIFICAÇÃO DIGITAL LTDA,,0.0,175.0,11563.4,INTER,Despesas administrativas,Outras,../data/raw/BANCO INTER-2024.xlsx
2024-06-20,PIX RECEBIDO CLAUDIA GABRIELA B GOTTERT,,465.0,0.0,12028.4,INTER,Receita com serviços,Manutenção s/ Garantia,../data/raw/BANCO INTER-2024.xlsx
2024-06-20,PIX ENVIADO PAGTO CARTÃO INTER,,0.0,4201.57,7826.83,INTER,Transferência (Crédito),Aplicação,../data/raw/BANCO INTER-2024.xlsx
2024-06-21,PIX ENVIADO PAULO REGINALDO DO NASCIMENTO - COMPRA DE TELHA P/ ECEEL,,0.0,50.0,7776.83,INTER,Despesa com serviços,Mão de obra,../data/raw/BANCO INTER-2024.xlsx
2024-06-21,PIX RECEBIDO JUSSARA JOECKEL,,30.0,0.0,7806.83,INTER,Receita com serviços,Manutenção s/ Garantia,../data/raw/BANCO INTER-2024.xlsx
2024-06-21,PIX RECEBIDO EDSON JAIR PFLUCK,,150.0,0.0,7956.83,INTER,Receita com serviços,Manutenção s/ Garantia,../data/raw/BANCO INTER-2024.xlsx
2024-06-24,PIX RECEBIDO EDUARDO VIDAL RIBEIRO,,890.0,0.0,8846.83,INTER,Receita com serviços,Manutenção s/ Garantia,../data/raw/BANCO INTER-2024.xlsx
2024-06-24,COMPRA CARTÃO - PIZZARIA DO JUNIOR - LANCHE HORAS EXTRAS,,0.0,67.98,8778.85,INTER,Despesa com pessoal,Alimentação (VR VA),../data/raw/BANCO INTER-2024.xlsx
2024-06-25,PIX RECEBIDO LUZIANE LOPES SOARES DE OLIVEIRA,,200.0,0.0,8978.85,INTER,Receita com serviços,Manutenção s/ Garantia,../data/raw/BANCO INTER-2024.xlsx
2024-06-26,PIX ENVIADO METROCARD - VT RONALDO,,0.0,127.4,8851.45,INTER,Despesa com pessoal,Transporte (VT),../data/raw/BANCO INTER-2024.xlsx
2024-06-26,PAGTO URBS - VALE TRANSPORTE RONALDO E NICOLAS,,0.0,417.03,8434.42,INTER,Despesa com pessoal,Transporte (VT),../data/raw/BANCO INTER-2024.xlsx
2024-06-28,PIX ENVIADO KAIO SPURI LIMA - VT ESTAGIÁRIO,,0.0,276.0,8158.42,INTER,Despesa com pessoal,Transporte (VT),../data/raw/BANCO INTER-2024.xlsx
2024-06-28,PIX ENVIADO JUAN VICTOR MARTINS - VT ATÉ O DIA 17/07,,0.0,156.0,8002.42,INTER,Despesa com pessoal,Transporte (VT),../data/raw/BANCO INTER-2024.xlsx
2024-06-28,PIX RECEBIDO Willian Gustavo Zuclinski,,480.0,0.0,8482.42,INTER,Receita com serviços,Manutenção s/ Garantia,../data/raw/BANCO INTER-2024.xlsx
2024-07-02,PIX RECEBIDO MARIANA ROSAS PIMENTEL,,400.0,0.0,8882.42,INTER,Receita com serviços,Manutenção s/ Garantia,../data/raw/BANCO INTER-2024.xlsx
2024-07-03,PIX RECEBIDO MIQUEIAS PINKOWSKI SANTOS,,260.0,0.0,9142.42,INTER,Receita com serviços,Manutenção s/ Garantia,../data/raw/BANCO INTER-2024.xlsx
2024-07-05,PIX RECEBIDO STONE PAGAMENTOS-MAQUININHA TON,,1266.59,0.0,10409.01,INTER,Receita com serviços,Manutenção s/ Garantia,../data/raw/BANCO INTER-2024.xlsx
2024-07-05,PIX ENVIADO JUAN VICTOR MARTINS - PAGTO DE SALÁRIO,,0.0,1480.49,8928.52,INTER,Despesa com pessoal,Salário,../data/raw/BANCO INTER-2024.xlsx
2024-07-05,PIX ENVIADO NICOLAS FALAVINHA CHRISTINO - PAGTO DE SALÁRIO,,0.0,1498.2,7430.2,INTER,Despesa com pessoal,Salário,../data/raw/BANCO INTER-2024.xlsx
2024-07-05,PIX RECEBIDO ELIZABETH TERESA BRUNINI SBARDELINI,,425.0,0.0,7855.32,INTER,Receita com serviços,Manutenção s/ Garantia,../data/raw/BANCO INTER-2024.xlsx
2024-07-05,PIX RECEBIDO MARIA CRISTINA PREVIERO DE TOLEDO,,180.0,0.0,8035.32,INTER,Receita com serviços,Manutenção s/ Garantia,../data/raw/BANCO INTER-2024.xlsx
2024-07-08,PIX RECEBIDO GUSTAVO H PEREIRA SOUZA,,250.0,0.0,8285.32,INTER,Receita com serviços,Manutenção s/ Garantia,../data/raw/BANCO INTER-2024.xlsx
2024-07-09,PIX RECEBIDO STONE PAGAMENTOS-MAQUININHA TON,,1333.71,0.0,9619.03,INTER,Receita com serviços,Manutenção s/ Garantia,../data/raw/BANCO INTER-2024.xlsx
2024-07-09,PIX RECEBIDO PIERRE MAURICE MEYTRE JUNIOR,,410.0,0.0,10029.03,INTER,Receita com serviços,Manutenção s/ Garantia,../data/raw/BANCO INTER-2024.xlsx
2024-07-09,PIX RECEBIDO CELY BERGAMO GARCIA,,360.0,0.0,10389.03,INTER,Receita com serviços,Manutenção s/ Garantia,../data/raw/BANCO INTER-2024.xlsx
2024-07-09,PIX ENVIADO SIMONE T S NAKANDAKARI - REF. SERVIÇOS PRESTADOS,,0.0,826.0,9563.03,INTER,Despesa com serviços,Mão de obra,../data/raw/BANCO INTER-2024.xlsx
2024-07-10,PIX RECEBIDO ELOI RUFATO JUNIOR,,650.0,0.0,10213.03,INTER,Receita com serviços,Manutenção s/ Garantia,../data/raw/BANCO INTER-2024.xlsx
2024-07-10,COMPRA CARTÃO - RECARGA DE CELULAR DA EMPRESA,,0.0,15.0,10198.03,INTER,Despesas administrativas,"Telefonia (Celular, Fixo, Internet)",../data/raw/BANCO INTER-2024.xlsx
2024-07-10,PAGAMENTO DO ALUGUEL DO IMOVEL,,0.0,4993.82,5204.21,INTER,Despesas administrativas,Aluguel imóvel,../data/raw/BANCO INTER-2024.xlsx
2024-07-10,PIX ENVIADO BIANCA NAKANDAKARI - VT ESTAGIÁRIA,,0.0,119.0,5085.21,INTER,Despesa com pessoal,Transporte (VT),../data/raw/BANCO INTER-2024.xlsx
2024-07-10,PIX RECEBIDO MATHEUS QUADROS,,385.0,0.0,5470.21,INTER,Receita com serviços,Manutenção s/ Garantia,../data/raw/BANCO INTER-2024.xlsx
2024-07-11,PIX RECEBIDO RAFAELLA MARINHO REQUIA GUIMARAES,,490.0,0.0,5960.21,INTER,Receita com serviços,Manutenção s/ Garantia,../data/raw/BANCO INTER-2024.xlsx
2024-07-11,COMPRA CARTÃO - MERCADO ZAMPROGAN,,0.0,6.0,5954.21,INTER,Despesas administrativas,Outras,../data/raw/BANCO INTER-2024.xlsx
2024-07-11,COMPRA CARTÃO - MERCADO ZAMPROGAN,,0.0,4.0,5960.21,INTER,Despesas administrativas,Outras,../data/raw/BANCO INTER-2024.xlsx
2024-07-11,COMPRA CARTÃO - MERCADO ZAMPROGAN,,0.0,8.0,5942.21,INTER,Despesas administrativas,Outras,../data/raw/BANCO INTER-2024.xlsx
2024-07-12,PIX ENVIADO - PORTOSEG SA CREDITO FIN E INV (PEDÁGIOS),,0.0,200.65,5741.56,INTER,Despesa com produtos,Fretes e Pedagios,../data/raw/BANCO INTER-2024.xlsx
2024-07-12,PIX RECEBIDO -NAIR DA ROCHA,,385.0,0.0,6126.56,INTER,Receita com serviços,Manutenção s/ Garantia,../data/raw/BANCO INTER-2024.xlsx
2024-07-12,PIX ENVIADO ROBSON - REF. REEMBOLSO POR USO DO CARRO,,0.0,730.7,5395.86,INTER,Despesa com serviços,Transporte,../data/raw/BANCO INTER-2024.xlsx
2024-07-15,PIX RECEBIDO DIEGO FERREIRA DE FRANCA,,30.0,0.0,5425.86,INTER,Receita com serviços,Manutenção s/ Garantia,../data/raw/BANCO INTER-2024.xlsx
2024-07-16,PIX RECEBIDO CARLA BUHRER SALLES ROSA,,490.0,0.0,5915.86,INTER,Receita com serviços,Manutenção s/ Garantia,../data/raw/BANCO INTER-2024.xlsx
2024-07-16,PIX ENVIADO P/ AG DE CORREIOS - SEDEX REF ENVIO DE PRODUTO P/ CLIENTE PIERRE,,0.0,41.3,5874.56,INTER,Despesa com produtos,Fretes e Pedagios,../data/raw/BANCO INTER-2024.xlsx
2024-07-16,PIX RECEBIDO STONE PAGAMENTOS-MAQUININHA TON,,1826.93,0.0,7701.49,INTER,Receita de vendas,Outras vendas,../data/raw/BANCO INTER-2024.xlsx
2024-07-17,PIX ENVIADO JUAN VICTOR MARTINS - VT DE 18/07 ATÉ 31/07,,0.0,120.0,7581.49,INTER,Despesa com pessoal,Transporte (VT),../data/raw/BANCO INTER-2024.xlsx
2024-07-17,PAGTO BOLETO SPRINGER CARRIER,,0.0,107.15,7474.34,INTER,Despesa com serviços,Peças,../data/raw/BANCO INTER-2024.xlsx
2024-07-18,PAGTO BOLETO SPRINGER CARRIER,,0.0,91.13,7383.21,INTER,Despesa com serviços,Peças,../data/raw/BANCO INTER-2024.xlsx
2024-07-19,PAGTO CARTÃO INTER,,0.0,2030.84,5352.37,INTER,Transferência (Crédito),Aplicação,../data/raw/BANCO INTER-2024.xlsx
2024-07-19,PIX RECEBIDO STONE PAGAMENTOS-MAQUININHA TON,,913.65,0.0,6266.02,INTER,Receita de vendas,Outras vendas,../data/raw/BANCO INTER-2024.xlsx
2024-07-19,PIX RECEBIDO NATHALIE A M DESSARTRE,,385.0,0.0,6651.02,INTER,Receita com serviços,Manutenção s/ Garantia,../data/raw/BANCO INTER-2024.xlsx
2024-07-19,PAGTO BOLETO SPRINGER CARRIER,,0.0,428.1,6222.92,INTER,Despesa com serviços,Peças,../data/raw/BANCO INTER-2024.xlsx
2024-07-22,PAGTO BOLETO SPRINGER CARRIER,,0.0,142.88,6080.04,INTER,Despesa com serviços,Peças,../data/raw/BANCO INTER-2024.xlsx
2024-07-22,PIX RECEBIDO CASA IDEAL CONSTRUCOES LTDA,,350.0,0.0,6430.04,INTER,Receita com serviços,Manutenção s/ Garantia,../data/raw/BANCO INTER-2024.xlsx
2024-07-23,PAGTO BOLETO SPRINGER CARRIER,,0.0,393.61,6036.43,INTER,Despesa com serviços,Peças,../data/raw/BANCO INTER-2024.xlsx
2024-07-24,PIX RECEBIDO JEANE APARECIDA AMARANTE DE LARA DENA,,280.0,0.0,6316.43,INTER,Receita com serviços,Manutenção s/ Garantia,../data/raw/BANCO INTER-2024.xlsx
2024-07-24,PIX ENVIADO PIERRE M. M. JUNIOR - DEV. DE PAGTO REF. TX SEDEX,,0.0,8.7,6307.73,INTER,Despesa com serviços,Outras,../data/raw/BANCO INTER-2024.xlsx
2024-07-24,PIX RECEBIDO LEONICE BELUCI CORTEZAO,,120.0,0.0,6427.73,INTER,Receita com serviços,Manutenção s/ Garantia,../data/raw/BANCO INTER-2024.xlsx
2024-07-26,PIX ENVIADO CLAUDIO - REEMBOLSO DE ALIMENTAÇÃO EM VIAGENS,,0.0,800.0,5627.73,INTER,Despesa com pessoal,Alimentação (VR VA),../data/raw/BANCO INTER-2024.xlsx
2024-07-28,PIX RECEBIDO FABIOLA DA SILVA DAMBROS,,230.0,0.0,5857.73,INTER,Receita com serviços,Manutenção s/ Garantia,../data/raw/BANCO INTER-2024.xlsx
2024-07-29,PAGTO BOLETO SPRINGER CARRIER,,0.0,791.7,5066.03,INTER,Despesa com serviços,Peças,../data/raw/BANCO INTER-2024.xlsx
2024-07-29,PAGTO BOLETO SPRINGER CARRIER,,0.0,497.32,4568.71,INTER,Despesa com serviços,Peças,../data/raw/BANCO INTER-2024.xlsx
2024-07-29,PAGTO BOLETO MASTER FILME,,0.0,320.08,4248.63,INTER,Despesa com produtos,Materiais de Consumo,../data/raw/BANCO INTER-2024.xlsx
2024-07-29,PIX RECEBIDO LEONICE BELUCI CORTEZAO,,120.0,0.0,4368.63,INTER,Receita com serviços,Manutenção s/ Garantia,../data/raw/BANCO INTER-2024.xlsx
2024-07-29,PIX RECEBIDO FRANCISCO SILVEIRA,,450.0,0.0,4818.63,INTER,Receita com serviços,Manutenção s/ Garantia,../data/raw/BANCO INTER-2024.xlsx
2024-07-29,PIX ENVIADO METROCARD - VT RONALDO,,0.0,121.9,4696.73,INTER,Despesa com pessoal,Transporte (VT),../data/raw/BANCO INTER-2024.xlsx
2024-07-29,PAGTO URBS - VALE TRANSPORTE RONALDO E NICOLAS,,0.0,399.03,4297.7,INTER,Despesa com pessoal,Transporte (VT),../data/raw/BANCO INTER-2024.xlsx
2024-07-29,PIX RECEBIDO STONE PAGAMENTOS-MAQUININHA TON,,141.36,0.0,4439.06,INTER,Receita de vendas,Outras vendas,../data/raw/BANCO INTER-2024.xlsx
2024-07-31,PIX RECEBIDO LOJAO DOS COLCHOES LTDA,,220.0,0.0,4659.06,INTER,Receita com serviços,Manutenção s/ Garantia,../data/raw/BANCO INTER-2024.xlsx
2024-07-31,PIX ENVIADO - KAIO SPURI LIMA - VT ESTAGIÁRIO,,0.0,264.0,4395.06,INTER,Despesa com pessoal,Transporte (VT),../data/raw/BANCO INTER-2024.xlsx
2024-07-31,PIX ENVIADO - BIANCA NAKANDAKARI - VT ESTAGIÁRIA,,0.0,154.0,4241.06,INTER,Despesa com pessoal,Transporte (VT),../data/raw/BANCO INTER-2024.xlsx
2024-07-31,PIX ENVIADO - JUAN VICTOR MARTINS - VT ATÉ O DIA 22/08,,0.0,192.0,4049.06,INTER,Despesa com pessoal,Transporte (VT),../data/raw/BANCO INTER-2024.xlsx
2024-07-31,PIX RECEBIDO PEDRO ANDRIOW,,385.0,0.0,4434.06,INTER,Receita com serviços,Manutenção s/ Garantia,../data/raw/BANCO INTER-2024.xlsx
2024-08-01,PIX RECEBIDO LUIS RONALDO GABARDO,,400.0,0.0,4834.06,INTER,Receita com serviços,Manutenção s/ Garantia,../data/raw/BANCO INTER-2024.xlsx
2024-08-02,PIX RECEBIDO PAUL LUCAS DREWS,,460.0,0.0,5294.06,INTER,Receita com serviços,Manutenção s/ Garantia,../data/raw/BANCO INTER-2024.xlsx
2024-08-02,PIX RECEBIDO VIVIAN CURI COSTA DA SILVA,,550.0,0.0,5844.06,INTER,Receita com serviços,Manutenção s/ Garantia,../data/raw/BANCO INTER-2024.xlsx
2024-08-02,PIX RECEBIDO VIVIAN CURI COSTA DA SILVA,,5.0,0.0,5849.06,INTER,Receita com serviços,Manutenção s/ Garantia,../data/raw/BANCO INTER-2024.xlsx
2024-08-05,PIX RECEBIDO PAGBANK - MAQUININHA DE CARTÃO,,2037.74,0.0,7886.8,INTER,Receita com serviços,Manutenção s/ Garantia,../data/raw/BANCO INTER-2024.xlsx
2024-08-05,PAGTO BOLETO MASTER FILME,,0.0,320.08,7566.72,INTER,Despesa com produtos,Outras,../data/raw/BANCO INTER-2024.xlsx
2024-08-05,PIX RECEBIDO PAGBANK - MAQUININHA DE CARTÃO,,574.71,0.0,8141.43,INTER,Receita com serviços,Manutenção s/ Garantia,../data/raw/BANCO INTER-2024.xlsx
2024-08-05,PIX RECEBIDO BRUNA CAROLINE FERRARI SOARES,,85.0,0.0,8226.43,INTER,Receita com serviços,Manutenção s/ Garantia,../data/raw/BANCO INTER-2024.xlsx
2024-08-05,PIX RECEBIDO MIQUEIAS PINKOWSKI SANTOS,,1355.0,0.0,9581.43,INTER,Receita com serviços,Manutenção s/ Garantia,../data/raw/BANCO INTER-2024.xlsx
2024-08-05,PIX RECEBIDO JULIANA PROCOPIO,,465.0,0.0,10046.43,INTER,Receita com serviços,Manutenção s/ Garantia,../data/raw/BANCO INTER-2024.xlsx
2024-08-06,PIX ENVIADO TAYANA LOPES DA SILVA - PAGTO DE SALÁRIO,,0.0,410.09,9636.34,INTER,Despesa com pessoal,Salário,../data/raw/BANCO INTER-2024.xlsx
2024-08-06,PIX ENVIADO ROBSON FERNANDES - PAGTO DE SALÁRIO,,0.0,2624.57,7011.77,INTER,Despesa com pessoal,Salário,../data/raw/BANCO INTER-2024.xlsx
2024-08-06,PIX ENVIADO JUAN VICTOR MARTINS - PAGTO DE SALÁRIO,,0.0,1521.99,5489.78,INTER,Despesa com pessoal,Salário,../data/raw/BANCO INTER-2024.xlsx
2024-08-06,PIX ENVIADO SIMONE NAKANDAKARI - SERVIÇOS ADMINISTRATIVOS E OUTROS,,0.0,2354.0,3135.78,INTER,Despesas administrativas,Outras,../data/raw/BANCO INTER-2024.xlsx
2024-08-06,PIX RECEBIDO PAGBANK - MAQUININHA DE CARTÃO,,2008.03,0.0,5143.81,INTER,Receita com serviços,Manutenção s/ Garantia,../data/raw/BANCO INTER-2024.xlsx
2024-08-07,PIX RECEBIDO VISON VIP COMERCIO DE ARTIGOS OTICOS,,40.0,0.0,5183.81,INTER,Receita com serviços,Manutenção s/ Garantia,../data/raw/BANCO INTER-2024.xlsx
2024-08-07,PIX RECEBIDO NAJARA DE ARAUJO REZENDE,,70.0,0.0,5253.81,INTER,Receita com serviços,Manutenção s/ Garantia,../data/raw/BANCO INTER-2024.xlsx
2024-08-07,PIX RECEBIDO TAYANARA KAMYLA RODRIGUES,,400.0,0.0,5653.81,INTER,Receita com serviços,Manutenção s/ Garantia,../data/raw/BANCO INTER-2024.xlsx
2024-08-07,PIX RECEBIDO RODRIGO RIBEIRO TOMAZ,,260.0,0.0,5913.81,INTER,Receita com serviços,Manutenção s/ Garantia,../data/raw/BANCO INTER-2024.xlsx
2024-08-07,PIX ENVIADO MATHEUS EYZAGUIRRE ARAUJO,,0.0,30.0,5883.81,INTER,Despesas administrativas,Outras,../data/raw/BANCO INTER-2024.xlsx
2024-08-08,PAGAMENTO DE ALUGUEL DO IMOVEL,,0.0,4967.52,916.29,INTER,Despesas administrativas,Aluguel imóvel,../data/raw/BANCO INTER-2024.xlsx
2024-08-08,PIX RECEBIDO EDUARDO IATZAC,,75.0,0.0,991.29,INTER,Receita com serviços,Manutenção s/ Garantia,../data/raw/BANCO INTER-2024.xlsx
2024-08-08,PAGTO TBR ADESIVOS E SELANTES,,0.0,705.32,285.97,INTER,Despesa com produtos,Outras,../data/raw/BANCO INTER-2024.xlsx
2024-08-08,PAGTO WHITE MARTINS,,0.0,266.13,19.84,INTER,Despesa com produtos,Outras,../data/raw/BANCO INTER-2024.xlsx
2024-08-09,PIX RECEBIDO NAJARA DE ARAUJO REZENDE,,70.0,0.0,89.84,INTER,Receita com serviços,Manutenção s/ Garantia,../data/raw/BANCO INTER-2024.xlsx
2024-08-10,PIX RECEBIDO ATILIO JOSE DE SOUZA,,290.0,0.0,379.84,INTER,Receita com serviços,Manutenção s/ Garantia,../data/raw/BANCO INTER-2024.xlsx
2024-08-12,PIX RECEBIDO WASHINGTON ROGERIO R COUTINHO,,40.0,0.0,419.84,INTER,Receita com serviços,Manutenção s/ Garantia,../data/raw/BANCO INTER-2024.xlsx
2024-08-12,PIX RECEBIDO LEANDRO SILVA,,270.0,0.0,689.84,INTER,Receita com serviços,Manutenção s/ Garantia,../data/raw/BANCO INTER-2024.xlsx
2024-08-12,PIX RECEBIDO BEATRIZ MATOS TEIXEIRA FREITAS,,385.0,0.0,1074.84,INTER,Receita com serviços,Manutenção s/ Garantia,../data/raw/BANCO INTER-2024.xlsx
2024-08-12,PAGTO WHITE MARTINS,,0.0,48.42,1026.42,INTER,Despesa com serviços,Outras,../data/raw/BANCO INTER-2024.xlsx
2024-08-12,PAGTO MASTER FILME EMBALAGENS,,0.0,320.07,706.35,INTER,Despesa com produtos,Outras,../data/raw/BANCO INTER-2024.xlsx
2024-08-13,PAGTO BOLETO GLOBAL EMBALAGEM,,0.0,460.0,246.35,INTER,Despesas administrativas,Outras,../data/raw/BANCO INTER-2024.xlsx
2024-08-13,PIX RECEBIDO PAGBANK - MAQUININHA DE CARTÃO,,1208.09,0.0,1454.44,INTER,Receita com serviços,Manutenção s/ Garantia,../data/raw/BANCO INTER-2024.xlsx
2024-08-14,PIX RECEBIDO KELLY DE SOUZA LIMA  ,,90.0,0.0,1544.44,INTER,Receita com serviços,Manutenção s/ Garantia,../data/raw/BANCO INTER-2024.xlsx
2024-08-14,PIX RECEBIDO EMMANUEL AUGUSTO DE OLIVEIRA CARLOS,,495.0,0.0,2039.44,INTER,Receita com serviços,Manutenção s/ Garantia,../data/raw/BANCO INTER-2024.xlsx
2024-08-14,PIX RECEBIDO PAGBANK - MAQUININHA DE CARTÃO,,664.35,0.0,2703.79,INTER,Receita com serviços,Manutenção s/ Garantia,../data/raw/BANCO INTER-2024.xlsx
2024-08-14,PIX RECEBIDO MARCIA IUNSZKOVSKI RIBEIRO,,400.0,0.0,3103.79,INTER,Receita com serviços,Manutenção s/ Garantia,../data/raw/BANCO INTER-2024.xlsx
2024-08-15,PIX RECEBIDO ELAINE SANTOS DA SILVA,,300.0,0.0,,INTER,Receita com serviços,Manutenção s/ Garantia,../data/raw/BANCO INTER-2024.xlsx
2024-08-15,PIX RECEBIDO PAGBANK - MAQUININHA DE CARTÃO,,1800.63,0.0,5204.42,INTER,Receita com serviços,Manutenção s/ Garantia,../data/raw/BANCO INTER-2024.xlsx
2024-08-15,PAGTO BOLETO PARANA CLINICAS,,0.0,947.71,,INTER,Despesa com pessoal,Assistência médica,../data/raw/BANCO INTER-2024.xlsx
2024-08-15,PAGTO CARTÃO AMEX,,0.0,2716.1,1540.61,INTER,Despesas administrativas,Outras,../data/raw/BANCO INTER-2024.xlsx
2024-08-15,PIX RECEBIDO ATILIO JOSE DE SOUZA,,290.0,0.0,,INTER,Receita com serviços,Manutenção s/ Garantia,../data/raw/BANCO INTER-2024.xlsx
2024-08-15,PIX RECEBIDO ALESSANDRO RODRIGO GERONDO,,410.0,0.0,2240.61,INTER,Receita com serviços,Manutenção s/ Garantia,../data/raw/BANCO INTER-2024.xlsx
2024-08-16,PIX RECEBIDO EDUARDO BARBOSA DOS SANTOS,,1400.0,0.0,3640.61,INTER,Receita com serviços,Manutenção s/ Garantia,../data/raw/BANCO INTER-2024.xlsx
2024-08-16,PAGTO BOLETO SPRINGER CARRIER,,0.0,107.15,,INTER,Despesa com serviços,Peças,../data/raw/BANCO INTER-2024.xlsx
2024-08-16,PAGTO BOLETO SPRINGER CARRIER,,0.0,91.13,3442.33,INTER,Despesa com serviços,Peças,../data/raw/BANCO INTER-2024.xlsx
2024-08-16,PIX RECEBIDO SAMARA DA CUNHA BRITO DA SILVA,,160.0,0.0,3602.33,INTER,Receita com serviços,Manutenção s/ Garantia,../data/raw/BANCO INTER-2024.xlsx
2024-08-16,PIX RECEBIDO Edso Luiz Mocelin,,645.0,0.0,,INTER,Receita com serviços,Manutenção s/ Garantia,../data/raw/BANCO INTER-2024.xlsx
2024-01-05,CREDITO TED - PAGSEGURO INTERNET LTDA,34055650,639.5,0.0,5297.97,CRED CREA,Receita com serviços,Outras,../data/raw/BANCO CRED CREA - 2024.xlsx
2024-01-05,PG.P/INTERNET - CONTA DE AGUA,10004106,0.0,267.2,5030.77,CRED CREA,Despesas administrativas,Água,../data/raw/BANCO CRED CREA - 2024.xlsx
2024-01-05,PG.P/INTERNET - PAGAMENTO FGTS,10004200,0.0,1337.71,3693.06,CRED CREA,Despesa com pessoal,FGTS,../data/raw/BANCO CRED CREA - 2024.xlsx
2024-01-05,PG.P/INTERNET - SPRINGER CARRIER,10006454,0.0,454.33,3238.73,CRED CREA,Despesas administrativas,Outras,../data/raw/BANCO CRED CREA - 2024.xlsx
2024-01-08,CREDITO TED - PAGSEGURO INTERNET LTDA,34511583,410.38,0.0,3649.11,CRED CREA,Receita com serviços,Outras,../data/raw/BANCO CRED CREA - 2024.xlsx
2024-01-10,PREST.EMPREST 003/048,2,0.0,2460.29,1188.82,CRED CREA,Despesas financeiras,Outras,../data/raw/BANCO CRED CREA - 2024.xlsx
2024-01-10,DB. ALLIANZ SEGURO RANGER  DE 6 DE 10,84624000166,0.0,184.61,1004.21,CRED CREA,Despesas administrativas,Seguro veicular,../data/raw/BANCO CRED CREA - 2024.xlsx
2024-01-10,DB. ALLIANZ SEGURO RANGER  DE 4 DE 09,46240001660,0.0,219.08,785.13,CRED CREA,Despesas administrativas,Seguro veicular,../data/raw/BANCO CRED CREA - 2024.xlsx
2024-01-10,CREDITO TED - PAGSEGURO INTERNET LTDA,34393369,1095.98,0.0,1881.11,CRED CREA,Receita com serviços,Outras,../data/raw/BANCO CRED CREA - 2024.xlsx
2024-01-11,CREDITO TED - PAGSEGURO INTERNET LTDA,33994334,693.66,0.0,2574.77,CRED CREA,Receita com serviços,Outras,../data/raw/BANCO CRED CREA - 2024.xlsx
2024-01-11,PG.P/INTERNET - EMBALATEC IND EMBALAGENS LTDA,10003339,0.0,824.6,1750.17,CRED CREA,Despesa com produtos,Materiais de Consumo,../data/raw/BANCO CRED CREA - 2024.xlsx
2024-01-15,DB. COTAS,19911,0.0,69.5,1680.67,CRED CREA,Despesas administrativas,Outras,../data/raw/BANCO CRED CREA - 2024.xlsx
2024-01-15,CREDITO TED - PAGSEGURO INTERNET LTDA,34220028,1052.57,0.0,2733.24,CRED CREA,Receita com serviços,Outras,../data/raw/BANCO CRED CREA - 2024.xlsx
2024-01-15,PG.P/INTERNET - SPRINGER CARRIER,10006159,0.0,1684.84,1048.4,CRED CREA,Despesas administrativas,Outras,../data/raw/BANCO CRED CREA - 2024.xlsx
2024-01-15,PG.P/INTERNET - PARANA CLINICAS - PLANOS DE SA,10006128,0.0,895.72,152.68,CRED CREA,Despesa com pessoal,Assistência médica,../data/raw/BANCO CRED CREA - 2024.xlsx
2024-01-16,CREDITO TED - PAGSEGURO INTERNET LTDA,33958870,374.3,0.0,526.98,CRED CREA,Receita com serviços,Outras,../data/raw/BANCO CRED CREA - 2024.xlsx
2024-01-19,CREDITO TED - PAGSEGURO INTERNET LTDA,34113353,3261.02,0.0,3788,CRED CREA,Receita com serviços,Outras,../data/raw/BANCO CRED CREA - 2024.xlsx
2024-01-24,PG.P/INTERNET - PACKPAR EMBALAGENS EIRELI,10001312,0.0,377.0,3411,CRED CREA,Despesa com produtos,Materiais de Consumo,../data/raw/BANCO CRED CREA - 2024.xlsx
2024-01-24,PG.P/INTERNET - CELULAR,10001321,0.0,64.54,3346.46,CRED CREA,Despesas administrativas,"Telefonia (Celular, Fixo, Internet)",../data/raw/BANCO CRED CREA - 2024.xlsx
2024-01-24,PG.P/INTERNET - NET FONE,10001327,0.0,136.0,3210.46,CRED CREA,Despesas administrativas,"Telefonia (Celular, Fixo, Internet)",../data/raw/BANCO CRED CREA - 2024.xlsx
2024-01-24,PG.P/INTERNET - LIGGA TELECOM,10001341,0.0,149.9,3060.56,CRED CREA,Despesas administrativas,Outras,../data/raw/BANCO CRED CREA - 2024.xlsx
2024-01-24,CREDITO TED - PAGSEGURO INTERNET LTDA,34100141,1720.24,0.0,4780.8,CRED CREA,Receita com serviços,Outras,../data/raw/BANCO CRED CREA - 2024.xlsx
2024-01-26,CREDITO TED - PAGSEGURO INTERNET LTDA,34086042,1085.47,0.0,5866.27,CRED CREA,Receita com serviços,Outras,../data/raw/BANCO CRED CREA - 2024.xlsx
2024-01-29,CREDITO TED - PAGSEGURO INTERNET LTDA,34203691,216.7,0.0,6082.97,CRED CREA,Receita com serviços,Outras,../data/raw/BANCO CRED CREA - 2024.xlsx
2024-01-29,PG.P/INTERNET - PACKPAR EMBALAGENS EIRELI,10003388,0.0,196.56,5886.41,CRED CREA,Despesa com produtos,Materiais de Consumo,../data/raw/BANCO CRED CREA - 2024.xlsx
2024-01-29,PG.P/INTERNET - VALE TRANSPORTE,10003456,0.0,573.03,5313.38,CRED CREA,Despesa com pessoal,Transporte (VT),../data/raw/BANCO CRED CREA - 2024.xlsx
2024-01-29,PG.P/INTERNET - MED CURITIBA,10003472,0.0,137.07,5176.31,CRED CREA,Despesa com pessoal,Assistência médica,../data/raw/BANCO CRED CREA - 2024.xlsx
2024-01-31,PG.P/INTERNET - VR BENEFICIOS E SERV. DE PROC.,10003899,0.0,1700.0,3476.31,CRED CREA,Despesa com pessoal,Transporte (VT),../data/raw/BANCO CRED CREA - 2024.xlsx
2024-02-05,CREDITO TED - PAGSEGURO INTERNET LTDA,34750103,1857.11,0.0,5333.42,CRED CREA,Receita com serviços,Outras,../data/raw/BANCO CRED CREA - 2024.xlsx
2024-02-05,PG.P/INTERNET - CONTA DE AGUA,10007042,0.0,204.88,5128.54,CRED CREA,Despesas administrativas,Água,../data/raw/BANCO CRED CREA - 2024.xlsx
2024-02-08,CREDITO TED - PAGSEGURO INTERNET LTDA,34018611,1557.23,0.0,6685.77,CRED CREA,Receita com serviços,Outras,../data/raw/BANCO CRED CREA - 2024.xlsx
2024-02-14,PG.P/INTERNET - REFRIGERACAO DUFRIO COMERCIO E,10005460,0.0,720.44,5965.33,CRED CREA,Despesas administrativas,Outras,../data/raw/BANCO CRED CREA - 2024.xlsx
2024-02-14,PG.P/INTERNET - SPRINGER CARRIER,10005474,0.0,1684.79,4280.54,CRED CREA,Despesas administrativas,Outras,../data/raw/BANCO CRED CREA - 2024.xlsx
2024-02-14,PREST.EMPREST 004/048,2,0.0,2460.29,1820.25,CRED CREA,Despesas financeiras,Outras,../data/raw/BANCO CRED CREA - 2024.xlsx
2024-02-14,DB. ALLIANZ SEGURO RANGER  DE 7 DE 10,84624000166,0.0,184.61,1635.64,CRED CREA,Despesas administrativas,Seguro veicular,../data/raw/BANCO CRED CREA - 2024.xlsx
2024-02-14,DB. ALLIANZ SEGURO RANGER  DE 5 DE 09,46240001660,0.0,219.08,1416.56,CRED CREA,Despesas administrativas,Seguro veicular,../data/raw/BANCO CRED CREA - 2024.xlsx
2024-02-14,CREDITO TED - PAGSEGURO INTERNET LTDA,34736976,638.71,0.0,2055.27,CRED CREA,Receita com serviços,Outras,../data/raw/BANCO CRED CREA - 2024.xlsx
2024-02-15,DB. COTAS,19911,0.0,69.5,1985.77,CRED CREA,Despesas administrativas,Outras,../data/raw/BANCO CRED CREA - 2024.xlsx
2024-02-15,PG.P/INTERNET - PARANA CLINICAS - CONSULTA,10005979,0.0,59.66,1926.11,CRED CREA,Despesa com pessoal,Assistência médica,../data/raw/BANCO CRED CREA - 2024.xlsx
2024-02-15,PG.P/INTERNET - PARANA CLINICAS - PLANOS DE SA,10006008,0.0,895.72,1030.39,CRED CREA,Despesa com pessoal,Assistência médica,../data/raw/BANCO CRED CREA - 2024.xlsx
2024-02-16,PG.P/INTERNET - ENERGIA LJ 3,10004766,0.0,180.74,849.65,CRED CREA,Despesas administrativas,Energia,../data/raw/BANCO CRED CREA - 2024.xlsx
2024-02-16,PG.P/INTERNET - ENERGIA LJ 4,10004769,0.0,61.34,788.31,CRED CREA,Despesas administrativas,Energia,../data/raw/BANCO CRED CREA - 2024.xlsx
2024-02-16,PG.P/INTERNET - ENERGIA LJ 6,10004783,0.0,642.9,145.41,CRED CREA,Despesas administrativas,Energia,../data/raw/BANCO CRED CREA - 2024.xlsx
2024-02-19,CREDITO TED - PAGSEGURO INTERNET LTDA,34370474,1052.94,0.0,1198.35,CRED CREA,Receita com serviços,Outras,../data/raw/BANCO CRED CREA - 2024.xlsx
2024-02-19,PG.P/INTERNET - DAIKIN AR COND BRASIL LTDA,10003338,0.0,880.18,318.17,CRED CREA,Despesas administrativas,Outras,../data/raw/BANCO CRED CREA - 2024.xlsx
2024-02-21,CREDITO TED - PAGSEGURO INTERNET LTDA,33991190,1199.98,0.0,1518.15,CRED CREA,Receita com serviços,Outras,../data/raw/BANCO CRED CREA - 2024.xlsx
2024-02-23,PG.P/INTERNET - NET FONE,10003548,0.0,136.0,1382.15,CRED CREA,Despesas administrativas,"Telefonia (Celular, Fixo, Internet)",../data/raw/BANCO CRED CREA - 2024.xlsx
2024-02-23,PG.P/INTERNET - LIGGA TELECOM,10003596,0.0,149.9,1232.25,CRED CREA,Despesas administrativas,Outras,../data/raw/BANCO CRED CREA - 2024.xlsx
2024-02-23,PG.P/INTERNET - CELULAR,10003606,0.0,64.54,1167.71,CRED CREA,Despesas administrativas,"Telefonia (Celular, Fixo, Internet)",../data/raw/BANCO CRED CREA - 2024.xlsx
2024-02-23,PG.P/INTERNET - MED CURITIBA,10003612,0.0,113.45,1054.26,CRED CREA,Despesa com pessoal,Assistência médica,../data/raw/BANCO CRED CREA - 2024.xlsx
2024-02-26,CREDITO TED - PAGSEGURO INTERNET LTDA,34256958,872.44,0.0,1926.7,CRED CREA,Receita com serviços,Outras,../data/raw/BANCO CRED CREA - 2024.xlsx
2024-02-26,CREDITO TED - PAGSEGURO INTERNET LTDA,33034351,990.15,0.0,2916.85,CRED CREA,Receita com serviços,Outras,../data/raw/BANCO CRED CREA - 2024.xlsx
2024-02-27,PG.P/INTERNET - VALE TRANSPORTE,10003497,0.0,603.03,2313.82,CRED CREA,Despesa com pessoal,Transporte (VT),../data/raw/BANCO CRED CREA - 2024.xlsx
2024-02-29,CREDITO TED - PAGSEGURO INTERNET LTDA,34614378,224.12,0.0,2537.94,CRED CREA,Receita com serviços,Outras,../data/raw/BANCO CRED CREA - 2024.xlsx
2024-02-29,PG.P/INTERNET - VR BENEFICIOS E SERV. DE PROC.,10004670,0.0,1550.0,987.94,CRED CREA,Despesa com pessoal,Alimentação (VR VA),../data/raw/BANCO CRED CREA - 2024.xlsx
2024-03-01,CREDITO TED - PAGSEGURO INTERNET LTDA,34647989,979.36,0.0,1967.3,CRED CREA,Receita com serviços,Outras,../data/raw/BANCO CRED CREA - 2024.xlsx
2024-03-04,PG.P/INTERNET - CONTA DE AGUA,10003958,0.0,175.7,1791.6,CRED CREA,Despesas administrativas,Água,../data/raw/BANCO CRED CREA - 2024.xlsx
2024-03-11,PREST.EMPREST 005/048,2,0.0,2460.29,-668.69,CRED CREA,Despesas financeiras,Outras,../data/raw/BANCO CRED CREA - 2024.xlsx
2024-03-11,DB. ALLIANZ SEGURO RANGER  DE 8 DE 10,84624000166,0.0,184.61,-853.3,CRED CREA,Despesas administrativas,Seguro veicular,../data/raw/BANCO CRED CREA - 2024.xlsx
2024-03-11,DB. ALLIANZ SEGURO RANGER  DE 6 DE 09,46240001660,0.0,219.08,-1072.38,CRED CREA,Despesas administrativas,Seguro veicular,../data/raw/BANCO CRED CREA - 2024.xlsx
2024-03-11,CREDITO TED - PAGSEGURO INTERNET LTDA,33012039,662.01,0.0,-410.37,CRED CREA,Receita com serviços,Outras,../data/raw/BANCO CRED CREA - 2024.xlsx
2024-03-11,CREDITO PIX -ECEELTEC ELETROELET -RECEBIDO DO BANCO INTER,385954507,420.0,0.0,9.63,CRED CREA,Receita com serviços,Outras,../data/raw/BANCO CRED CREA - 2024.xlsx
2024-03-13,CREDITO TED - PAGSEGURO INTERNET LTDA,34141047,826.43,0.0,836.06,CRED CREA,Receita com serviços,Outras,../data/raw/BANCO CRED CREA - 2024.xlsx
2024-03-05,DB. COTAS,19911,0.0,69.5,766.56,CRED CREA,Despesas administrativas,Outras,../data/raw/BANCO CRED CREA - 2024.xlsx
2024-03-15,CREDITO TED - PAGSEGURO INTERNET LTDA,34751657,2889.25,0.0,3655.81,CRED CREA,Receita com serviços,Outras,../data/raw/BANCO CRED CREA - 2024.xlsx
2024-03-15,PG.P/INTERNET - CARTAO AMERICAN,10006916,0.0,2745.61,910.2,CRED CREA,Despesas administrativas,Outras,../data/raw/BANCO CRED CREA - 2024.xlsx
2024-03-15,PG.P/INTERNET - WHITE MARTINS,10006989,0.0,48.42,861.78,CRED CREA,Despesa com produtos,Materiais de Consumo,../data/raw/BANCO CRED CREA - 2024.xlsx
2024-03-15,PG.P/INTERNET - ENERGIA LJ 3,10007005,0.0,172.97,688.81,CRED CREA,Despesas administrativas,Energia,../data/raw/BANCO CRED CREA - 2024.xlsx
2024-03-15,PG.P/INTERNET - ENERGIA LJ 4,10007017,0.0,55.27,633.54,CRED CREA,Despesas administrativas,Energia,../data/raw/BANCO CRED CREA - 2024.xlsx
2024-03-15,PG.P/INTERNET - ENERGIA LJ 6,10007059,0.0,493.1,140.44,CRED CREA,Despesas administrativas,Energia,../data/raw/BANCO CRED CREA - 2024.xlsx
2024-03-18,CREDITO TED - PAGSEGURO INTERNET LTDA,34457213,1014.13,0.0,1154.57,CRED CREA,Receita com serviços,Outras,../data/raw/BANCO CRED CREA - 2024.xlsx
2024-03-18,PG.P/INTERNET - FRESNOMAQ INDUSTRIA DE MAQUINA,10005587,0.0,213.37,941.2,CRED CREA,Despesas administrativas,Outras,../data/raw/BANCO CRED CREA - 2024.xlsx
2024-03-19,CREDITO TED - PAGSEGURO INTERNET LTDA,33935131,1187.31,0.0,2128.51,CRED CREA,Receita com serviços,Outras,../data/raw/BANCO CRED CREA - 2024.xlsx
2024-03-20,CREDITO TED - PAGSEGURO INTERNET LTDA,34487257,625.08,0.0,2753.59,CRED CREA,Receita com serviços,Outras,../data/raw/BANCO CRED CREA - 2024.xlsx
2024-03-21,CREDITO TED - PAGSEGURO INTERNET LTDA,34091135,117.25,0.0,2870.84,CRED CREA,Receita com serviços,Outras,../data/raw/BANCO CRED CREA - 2024.xlsx
2024-03-22,CREDITO TED - PAGSEGURO INTERNET LTDA,34028776,250.51,0.0,3121.35,CRED CREA,Receita com serviços,Outras,../data/raw/BANCO CRED CREA - 2024.xlsx
2024-03-25,CREDITO TED - PAGSEGURO INTERNET LTDA,34456285,233.76,0.0,3355.11,CRED CREA,Receita com serviços,Outras,../data/raw/BANCO CRED CREA - 2024.xlsx
2024-03-25,PG.P/INTERNET - NET FONE,10006069,0.0,154.53,3200.58,CRED CREA,Despesas administrativas,"Telefonia (Celular, Fixo, Internet)",../data/raw/BANCO CRED CREA - 2024.xlsx
2024-03-25,PG.P/INTERNET - LIGGA TELECOM,10006089,0.0,149.9,3050.68,CRED CREA,Despesas administrativas,Outras,../data/raw/BANCO CRED CREA - 2024.xlsx
2024-03-25,PG.P/INTERNET - CELULAR,10006108,0.0,69.18,2981.5,CRED CREA,Despesas administrativas,"Telefonia (Celular, Fixo, Internet)",../data/raw/BANCO CRED CREA - 2024.xlsx
2024-03-25,PG.P/INTERNET - MED CURITIBA,10006123,0.0,126.53,2854.97,CRED CREA,Despesa com pessoal,Assistência médica,../data/raw/BANCO CRED CREA - 2024.xlsx
2024-03-25,PG.P/INTERNET - FRESNOMAQ INDUSTRIA DE MAQUINA,10006178,0.0,155.56,2699.41,CRED CREA,Despesas administrativas,Outras,../data/raw/BANCO CRED CREA - 2024.xlsx
2024-03-28,PG.P/INTERNET - VR BENEFICIOS E SERV. DE PROC.,10003844,0.0,1950.0,749.41,CRED CREA,Despesa com pessoal,Alimentação (VR VA),../data/raw/BANCO CRED CREA - 2024.xlsx
2024-03-28,PG.P/INTERNET - CONSELHO REGIONAL DOS TECNICOS-ECEEL-TEC,10003938,0.0,337.4,412.01,CRED CREA,Despesas administrativas,Contabilidade,../data/raw/BANCO CRED CREA - 2024.xlsx
2024-03-28,PG.P/INTERNET - CONSELHO REGIONAL DOS TECNICOS-CLAUDIO,10003967,0.0,337.4,74.61,CRED CREA,Despesas administrativas,Contabilidade,../data/raw/BANCO CRED CREA - 2024.xlsx
2024-03-28,CREDITO TED - PAGSEGURO INTERNET LTDA,34724271,1357.23,0.0,1431.84,CRED CREA,Receita com serviços,Outras,../data/raw/BANCO CRED CREA - 2024.xlsx
2024-04-03,PG.P/INTERNET - CONTA DE AGUA,10002681,0.0,287.98,1143.86,CRED CREA,Despesas administrativas,Água,../data/raw/BANCO CRED CREA - 2024.xlsx
2024-04-09,CREDITO TED - PAGSEGURO INTERNET LTDA,34059864,558.78,0.0,1702.64,CRED CREA,Receita com serviços,Outras,../data/raw/BANCO CRED CREA - 2024.xlsx
2024-04-10,PREST.EMPREST 006/048,2,0.0,2460.29,-757.65,CRED CREA,Despesas financeiras,Outras,../data/raw/BANCO CRED CREA - 2024.xlsx
2024-04-10,DB. ALLIANZ SEGURO RANGER  DE 9 DE 10,84624000166,0.0,184.61,-942.26,CRED CREA,Despesas administrativas,Seguro veicular,../data/raw/BANCO CRED CREA - 2024.xlsx
2024-04-10,DB. ALLIANZ SEGURO RANGER  DE 7 DE 09,46240001660,0.0,219.08,-1161.34,CRED CREA,Despesas administrativas,Seguro veicular,../data/raw/BANCO CRED CREA - 2024.xlsx
2024-04-10,CREDITO TED - PAGSEGURO INTERNET LTDA,34438433,1095.49,0.0,-65.85,CRED CREA,Receita com serviços,Outras,../data/raw/BANCO CRED CREA - 2024.xlsx
2024-04-10,CREDITO PIX - ECEELTEC ELETROELET,401713286,100.0,0.0,34.15,CRED CREA,Receita com serviços,Outras,../data/raw/BANCO CRED CREA - 2024.xlsx
2024-04-12,CREDITO TED - PAGSEGURO INTERNET LTDA,34113849,1238.74,0.0,1272.89,CRED CREA,Receita com serviços,Outras,../data/raw/BANCO CRED CREA - 2024.xlsx
2024-04-15,CREDITO PIX - ECEEL-TEC ELETROELETRONICA INFORMA,403652523,389.66,0.0,1662.55,CRED CREA,Receita com serviços,Outras,../data/raw/BANCO CRED CREA - 2024.xlsx
2024-04-15,DB. COTAS,19911,0.0,69.5,1593.05,CRED CREA,Despesas administrativas,Outras,../data/raw/BANCO CRED CREA - 2024.xlsx
2024-04-15,PG.P/INTERNET - PARANA CLINICAS - PLANOS DE SA,10004323,0.0,1069.79,523.26,CRED CREA,Despesa com pessoal,Assistência médica,../data/raw/BANCO CRED CREA - 2024.xlsx
2024-04-15,CREDITO TED - PAGSEGURO INTERNET LTDA,34914171,492.66,0.0,1015.92,CRED CREA,Receita com serviços,Outras,../data/raw/BANCO CRED CREA - 2024.xlsx
2024-04-16,PG.P/INTERNET - ENERGIA LJ 3,10001610,0.0,190.32,825.6,CRED CREA,Despesas administrativas,Energia,../data/raw/BANCO CRED CREA - 2024.xlsx
2024-04-16,PG.P/INTERNET - ENERGIA LJ 4,10001616,0.0,59.85,765.75,CRED CREA,Despesas administrativas,Energia,../data/raw/BANCO CRED CREA - 2024.xlsx
2024-04-16,PG.P/INTERNET - ENERGIA LJ 6,10001628,0.0,488.82,276.93,CRED CREA,Despesas administrativas,Energia,../data/raw/BANCO CRED CREA - 2024.xlsx
2024-04-16,CREDITO TED - PAGSEGURO INTERNET LTDA,34057067,386.4,0.0,663.33,CRED CREA,Receita com serviços,Outras,../data/raw/BANCO CRED CREA - 2024.xlsx
2024-04-18,CREDITO TED - PAGSEGURO INTERNET LTDA,33999768,241.32,0.0,904.65,CRED CREA,Receita com serviços,Outras,../data/raw/BANCO CRED CREA - 2024.xlsx
2024-04-19,CREDITO PIX - PAGSEGURO INTERNET LTDA,406376516,1520.18,0.0,2424.83,CRED CREA,Receita com serviços,Outras,../data/raw/BANCO CRED CREA - 2024.xlsx
2024-04-23,CREDITO TED - PAGSEGURO INTERNET LTDA,34021425,3018.73,0.0,5443.56,CRED CREA,Receita com serviços,Outras,../data/raw/BANCO CRED CREA - 2024.xlsx
2024-04-25,PG.P/INTERNET - NET FONE,10003245,0.0,140.11,5303.45,CRED CREA,Despesas administrativas,"Telefonia (Celular, Fixo, Internet)",../data/raw/BANCO CRED CREA - 2024.xlsx
2024-04-25,PG.P/INTERNET - LIGGA TELECOM,10003262,0.0,149.9,5153.55,CRED CREA,Despesas administrativas,Outras,../data/raw/BANCO CRED CREA - 2024.xlsx
2024-04-25,PG.P/INTERNET - CELULAR,10003278,0.0,70.12,5083.43,CRED CREA,Despesas administrativas,"Telefonia (Celular, Fixo, Internet)",../data/raw/BANCO CRED CREA - 2024.xlsx
2024-04-25,PG.P/INTERNET - MED CURITIBA,10003290,0.0,105.45,4977.98,CRED CREA,Despesa com pessoal,Assistência médica,../data/raw/BANCO CRED CREA - 2024.xlsx
2024-04-29,PG.P/INTERNET - VALE TRANSPORTE,10001866,0.0,567.03,4410.95,CRED CREA,Despesa com pessoal,Transporte (VT),../data/raw/BANCO CRED CREA - 2024.xlsx
2024-04-30,PG.P/INTERNET - VR BENEFICIOS E SERV. DE PROC.,10002381,0.0,1950.0,2460.95,CRED CREA,Despesa com pessoal,Alimentação (VR VA),../data/raw/BANCO CRED CREA - 2024.xlsx
2024-05-06,PG.P/INTERNET - CONTA DE AGUA,10006718,0.0,184.1,2276.85,CRED CREA,Despesas administrativas,Água,../data/raw/BANCO CRED CREA - 2024.xlsx
2024-05-07,CREDITO TED - PAGSEGURO INTERNET LTDA,34966778,1319.9,0.0,3596.75,CRED CREA,Receita com serviços,Outras,../data/raw/BANCO CRED CREA - 2024.xlsx
2024-05-08,PG.P/INTERNET - CIEE - PR,10003674,0.0,550.19,3046.56,CRED CREA,Despesa com pessoal,Outras,../data/raw/BANCO CRED CREA - 2024.xlsx
2024-05-10,PREST.EMPREST 007/048 - COMPRA DA RANGER,2,0.0,2460.29,586.27,CRED CREA,Despesas administrativas,Veiculos,../data/raw/BANCO CRED CREA - 2024.xlsx
2024-05-10,DB. ALLIANZ SEGURO RANGER  DE 10 DE 10,84624000166,0.0,184.72,401.55,CRED CREA,Despesas administrativas,Seguro veicular,../data/raw/BANCO CRED CREA - 2024.xlsx
2024-05-10,DB. ALLIANZ SEGURO RANGER  DE 08 DE 09,46240001660,0.0,219.08,182.47,CRED CREA,Despesas administrativas,Seguro veicular,../data/raw/BANCO CRED CREA - 2024.xlsx
2024-05-10,PG.P/INTERNET - WHITE MARTINS,10004083,0.0,48.42,134.05,CRED CREA,Despesa com produtos,Materiais de Consumo,../data/raw/BANCO CRED CREA - 2024.xlsx
2024-05-10,CREDITO TED - PAGSEGURO INTERNET LTDA,34331348,386.4,0.0,520.45,CRED CREA,Receita com serviços,Outras,../data/raw/BANCO CRED CREA - 2024.xlsx
2024-05-13,PG.P/INTERNET - REFRIGERACAO DUFRIO COMERCIO E,10006488,0.0,311.32,209.13,CRED CREA,Despesas administrativas,Outras,../data/raw/BANCO CRED CREA - 2024.xlsx
2024-05-13,CREDITO TED - PAGSEGURO INTERNET LTDA,34454997,165.55,0.0,374.68,CRED CREA,Receita com serviços,Outras,../data/raw/BANCO CRED CREA - 2024.xlsx
2024-05-15,DB. COTAS,19911,0.0,69.5,305.18,CRED CREA,Despesas administrativas,Outras,../data/raw/BANCO CRED CREA - 2024.xlsx
2024-05-15,CREDITO TED - PAGSEGURO INTERNET LTDA,34852816,464.4,0.0,769.58,CRED CREA,Receita com serviços,Outras,../data/raw/BANCO CRED CREA - 2024.xlsx
2024-05-16,CREDITO TED - PAGSEGURO INTERNET LTDA,34126331,631.89,0.0,1401.47,CRED CREA,Receita com serviços,Outras,../data/raw/BANCO CRED CREA - 2024.xlsx
2024-05-17,CREDITO PIX - PAGSEGURO INTERNET LTDA,421413937,168.05,0.0,1569.52,CRED CREA,Receita com serviços,Outras,../data/raw/BANCO CRED CREA - 2024.xlsx
2024-05-21,CREDITO PIX - PAGSEGURO INTERNET LTDA,423305479,1372.11,0.0,2941.63,CRED CREA,Receita com serviços,Outras,../data/raw/BANCO CRED CREA - 2024.xlsx
2024-05-23,CREDITO PIX - PAGSEGURO INTERNET LTDA,424120150,1025.69,0.0,3967.32,CRED CREA,Receita com serviços,Outras,../data/raw/BANCO CRED CREA - 2024.xlsx
2024-05-27,CREDITO PIX - PAGSEGURO INTERNET LTDA,425441430,1202.67,0.0,5169.99,CRED CREA,Receita com serviços,Outras,../data/raw/BANCO CRED CREA - 2024.xlsx
2024-05-27,PG.P/INTERNET - CELULAR,10004203,0.0,70.12,5099.87,CRED CREA,Despesas administrativas,"Telefonia (Celular, Fixo, Internet)",../data/raw/BANCO CRED CREA - 2024.xlsx
2024-05-27,PG.P/INTERNET - LIGGA TELECOM,10004224,0.0,149.9,4949.97,CRED CREA,Despesas administrativas,Outras,../data/raw/BANCO CRED CREA - 2024.xlsx
2024-05-27,PG.P/INTERNET - NET FONE,10004235,0.0,139.96,4810.01,CRED CREA,Despesas administrativas,"Telefonia (Celular, Fixo, Internet)",../data/raw/BANCO CRED CREA - 2024.xlsx
2024-05-27,PG.P/INTERNET - MED CURITIBA,10004263,0.0,105.45,4704.56,CRED CREA,Despesa com pessoal,Assistência médica,../data/raw/BANCO CRED CREA - 2024.xlsx
2024-05-27,PG.P/INTERNET - VT - NICOLAS E RONALDO,10004295,0.0,363.03,4341.53,CRED CREA,Despesa com pessoal,Transporte (VT),../data/raw/BANCO CRED CREA - 2024.xlsx
2024-05-28,CREDITO PIX - PAGSEGURO INTERNET LTDA,426238583,137.14,0.0,4478.67,CRED CREA,Receita com serviços,Outras,../data/raw/BANCO CRED CREA - 2024.xlsx
2024-05-29,PG.P/INTERNET - VR BENEFICIOS E SERV. DE PROC.,10002935,0.0,1750.0,2728.67,CRED CREA,Despesa com pessoal,Alimentação (VR VA),../data/raw/BANCO CRED CREA - 2024.xlsx
2024-05-29,CREDITO PIX - PAGSEGURO INTERNET LTDA,426782773,193.96,0.0,2922.63,CRED CREA,Receita com serviços,Outras,../data/raw/BANCO CRED CREA - 2024.xlsx
2024-06-07,CREDITO TED - PAGSEGURO INTERNET LTDA,34301847,905.0,0.0,3827.63,CRED CREA,Receita com serviços,Outras,../data/raw/BANCO CRED CREA - 2024.xlsx
2024-06-10,PREST.EMPREST 008/048 - COMPRA DA RANGER,2,0.0,2460.29,1367.34,CRED CREA,Despesas administrativas,Veiculos,../data/raw/BANCO CRED CREA - 2024.xlsx
2024-06-10,DB. ALLIANZ SEGURO RANGER  DE 09 DE 09,84624000166,0.0,219.26,1148.08,CRED CREA,Despesas administrativas,Seguro veicular,../data/raw/BANCO CRED CREA - 2024.xlsx
2024-06-10,CREDITO PIX - PAGSEGURO INTERNET LTDA,433909114,2348.52,0.0,3496.6,CRED CREA,Receita com serviços,Outras,../data/raw/BANCO CRED CREA - 2024.xlsx
2024-06-02,CREDITO TED - PAGSEGURO INTERNET LTDA,34195161,2242.17,0.0,5738.77,CRED CREA,Receita com serviços,Outras,../data/raw/BANCO CRED CREA - 2024.xlsx
2024-06-14,CREDITO TED - PAGSEGURO INTERNET LTDA,34322327,1936.83,0.0,7675.6,CRED CREA,Receita com serviços,Outras,../data/raw/BANCO CRED CREA - 2024.xlsx
2024-06-14,PG.P/INTERNET - PARANA CLINICAS - PLANOS DE SA,10003193,0.0,1069.79,6605.81,CRED CREA,Despesa com pessoal,Assistência médica,../data/raw/BANCO CRED CREA - 2024.xlsx
2024-06-14,PG.P/INTERNET - SPRINGER CARRIER - NF 826885 - 1 DE 2,10003220,0.0,68.35,6537.46,CRED CREA,Despesas administrativas,Outras,../data/raw/BANCO CRED CREA - 2024.xlsx
2024-06-14,PG.P/INTERNET - ENERGIA LJ 3,10003250,0.0,170.28,6367.18,CRED CREA,Despesas administrativas,Energia,../data/raw/BANCO CRED CREA - 2024.xlsx
2024-06-14,PG.P/INTERNET - ENERGIA LJ 4,10003283,0.0,68.08,6299.1,CRED CREA,Despesas administrativas,Energia,../data/raw/BANCO CRED CREA - 2024.xlsx
2024-06-14,PG.P/INTERNET - ENERGIA LJ 6,10003298,0.0,480.96,5818.14,CRED CREA,Despesas administrativas,Energia,../data/raw/BANCO CRED CREA - 2024.xlsx
2024-06-17,DB. COTAS,19911,0.0,69.5,5748.64,CRED CREA,Despesas administrativas,Outras,../data/raw/BANCO CRED CREA - 2024.xlsx
2024-06-17,CREDITO PIX - ECEEL-TEC ELETROELETRONICA INFORMA,437707788,801.78,0.0,6550.42,CRED CREA,Receita com serviços,Outras,../data/raw/BANCO CRED CREA - 2024.xlsx
2024-06-18,CREDITO PIX - ECEEL-TEC ELETROELETRONICA INFORMA,438369471,1358.54,0.0,7908.96,CRED CREA,Receita com serviços,Outras,../data/raw/BANCO CRED CREA - 2024.xlsx
2024-06-20,CREDITO PIX - ECEEL-TEC ELETROELETRONICA INFORMA,439343660,492.5,0.0,8401.46,CRED CREA,Receita com serviços,Outras,../data/raw/BANCO CRED CREA - 2024.xlsx
2024-06-20,PG.P/INTERNET - VR BENEFICIOS E SERV. DE PROC. - VR JUAN,10006532,0.0,200.0,8201.46,CRED CREA,Despesa com pessoal,Alimentação (VR VA),../data/raw/BANCO CRED CREA - 2024.xlsx
2024-06-24,CREDITO PIX - ECEEL-TEC ELETROELETRONICA INFORMA,441277519,1173.69,0.0,9375.15,CRED CREA,Receita com serviços,Outras,../data/raw/BANCO CRED CREA - 2024.xlsx
2024-06-25,PG.P/INTERNET - MED CURITIBA,10002010,0.0,115.99,9259.16,CRED CREA,Despesa com pessoal,Assistência médica,../data/raw/BANCO CRED CREA - 2024.xlsx
2024-06-25,PG.P/INTERNET - NET FONE,10002018,0.0,147.89,9111.27,CRED CREA,Despesas administrativas,"Telefonia (Celular, Fixo, Internet)",../data/raw/BANCO CRED CREA - 2024.xlsx
2024-06-25,PG.P/INTERNET - CELULAR,10002039,0.0,70.12,9041.15,CRED CREA,Despesas administrativas,"Telefonia (Celular, Fixo, Internet)",../data/raw/BANCO CRED CREA - 2024.xlsx
2024-06-25,PG.P/INTERNET - LIGGA TELECOM,10002069,0.0,149.9,8891.25,CRED CREA,Despesas administrativas,Outras,../data/raw/BANCO CRED CREA - 2024.xlsx
2024-06-25,PG.P/INTERNET - SPRINGER CARRIER,10002090,0.0,497.32,8393.93,CRED CREA,Despesas administrativas,Outras,../data/raw/BANCO CRED CREA - 2024.xlsx
2024-06-25,CREDITO TED - PAGSEGURO INTERNET LTDA,34192564,487.83,0.0,8881.76,CRED CREA,Receita com serviços,Outras,../data/raw/BANCO CRED CREA - 2024.xlsx
2024-06-28,PG.P/INTERNET - VR BENEFICIOS E SERV. DE PROC.,10002932,0.0,1800.0,7081.76,CRED CREA,Despesa com pessoal,Alimentação (VR VA),../data/raw/BANCO CRED CREA - 2024.xlsx
2024-07-01,PG.P/INTERNET - SPRINGER CARRIER NF 825745 - 2 DE 2 parc.,10005538,0.0,376.66,6705.1,CRED CREA,Despesas administrativas,Outras,../data/raw/BANCO CRED CREA - 2024.xlsx
2024-07-05,PG.P/INTERNET - CONTA DE AGUA,10002355,0.0,210.86,6494.24,CRED CREA,Despesas administrativas,Água,../data/raw/BANCO CRED CREA - 2024.xlsx
2024-07-08,PG.P/INTERNET - SPRINGER CARRIER (REF. SERV. DE INSTALAÇÃO CARTÃO SIM),10006896,0.0,98.35,6395.89,CRED CREA,Despesas administrativas,Outras,../data/raw/BANCO CRED CREA - 2024.xlsx
2024-07-08,PG.P/INTERNET - REFRIGERACAO DUFRIO COMERCIO E,10006908,0.0,311.22,6084.67,CRED CREA,Despesas administrativas,Outras,../data/raw/BANCO CRED CREA - 2024.xlsx
2024-07-08,PG.P/INTERNET - CIEE - PR (ESTAGIÁRIO),10006921,0.0,550.19,5534.48,CRED CREA,Despesa com pessoal,Outras,../data/raw/BANCO CRED CREA - 2024.xlsx
2024-07-10,PREST.EMPREST 009/048  - COMPRA DA RANGER,3,0.0,2460.29,3074.19,CRED CREA,Despesas administrativas,Veiculos,../data/raw/BANCO CRED CREA - 2024.xlsx
2024-07-15,DB. COTAS,19911,0.0,69.5,3004.69,CRED CREA,Despesas administrativas,Outras,../data/raw/BANCO CRED CREA - 2024.xlsx
2024-07-15,PG.P/INTERNET - WHITE MARTINS,10005438,0.0,48.42,2956.27,CRED CREA,Despesa com produtos,Materiais de Consumo,../data/raw/BANCO CRED CREA - 2024.xlsx
2024-07-15,PG.P/INTERNET - PARANA CLINICAS - PLANOS DE SA,10005514,0.0,854.12,2102.15,CRED CREA,Despesa com pessoal,Assistência médica,../data/raw/BANCO CRED CREA - 2024.xlsx
2024-07-15,PG.P/INTERNET - ENERGIA LJ 3,10005569,0.0,175.07,1927.08,CRED CREA,Despesas administrativas,Energia,../data/raw/BANCO CRED CREA - 2024.xlsx
2024-07-15,PG.P/INTERNET - ENERGIA LJ 4,10005736,0.0,51.43,1875.65,CRED CREA,Despesas administrativas,Energia,../data/raw/BANCO CRED CREA - 2024.xlsx
2024-07-15,PG.P/INTERNET - ENERGIA LJ 6,10005746,0.0,446.74,1428.91,CRED CREA,Despesas administrativas,Energia,../data/raw/BANCO CRED CREA - 2024.xlsx
2024-07-15,PG.P/INTERNET - SPRINGER CARRIER,10005793,0.0,68.35,1360.56,CRED CREA,Despesas administrativas,Outras,../data/raw/BANCO CRED CREA - 2024.xlsx
2024-07-19,CREDITO TED - PAGSEGURO INTERNET LTDA,34178064,24.73,0.0,1385.29,CRED CREA,Receita com serviços,Outras,../data/raw/BANCO CRED CREA - 2024.xlsx
2024-07-24,CREDITO PIX - STONE PAGAMENTOS-MAQUININHA TON,457654032,1868.4,0.0,3253.69,CRED CREA,Receita com serviços,Outras,../data/raw/BANCO CRED CREA - 2024.xlsx
2024-07-25,PG.P/INTERNET - CELULAR,10002282,0.0,70.12,3183.57,CRED CREA,Despesas administrativas,"Telefonia (Celular, Fixo, Internet)",../data/raw/BANCO CRED CREA - 2024.xlsx
2024-07-25,PG.P/INTERNET - LIGGA TELECOM,10002284,0.0,149.9,3033.67,CRED CREA,Despesas administrativas,Outras,../data/raw/BANCO CRED CREA - 2024.xlsx
2024-07-25,PG.P/INTERNET - NET FONE,10002319,0.0,139.96,2893.71,CRED CREA,Despesas administrativas,"Telefonia (Celular, Fixo, Internet)",../data/raw/BANCO CRED CREA - 2024.xlsx
2024-07-25,PG.P/INTERNET - MED CURITIBA,10002338,0.0,156.9,2736.81,CRED CREA,Despesa com pessoal,Assistência médica,../data/raw/BANCO CRED CREA - 2024.xlsx
2024-07-26,CREDITO PIX - STONE PAGAMENTOS-MAQUININHA TON,458789355,1000.0,0.0,3736.81,CRED CREA,Receita com serviços,Outras,../data/raw/BANCO CRED CREA - 2024.xlsx
2024-07-30,CREDITO PIX - PAGSEGURO INTERNET LTDA,460372221,39.4,0.0,3776.21,CRED CREA,Receita com serviços,Outras,../data/raw/BANCO CRED CREA - 2024.xlsx
2024-07-31,PG.P/INTERNET - VR BENEFICIOS E SERV. DE PROC.,10003049,0.0,2053.34,1722.87,CRED CREA,Despesa com pessoal,Alimentação (VR VA),../data/raw/BANCO CRED CREA - 2024.xlsx
2024-07-31,PG.P/INTERNET - JUNTA COMERCIAL,10003118,0.0,44.2,1678.67,CRED CREA,Despesas administrativas,Cartório,../data/raw/BANCO CRED CREA - 2024.xlsx
2024-08-09,CREDITO PIX - PAGBANK - MAQUININHA DE CARTÃO,466925811,2745.16,0.0,4423.83,CRED CREA,Receita com serviços,Outras,../data/raw/BANCO CRED CREA - 2024.xlsx
2024-08-12,PREST.EMPREST 010/048 - COMPRA DA RANGER,3,0.0,2460.29,1963.54,CRED CREA,Despesas administrativas,Veiculos,../data/raw/BANCO CRED CREA - 2024.xlsx
2024-08-15,DB. COTAS,19911,0.0,69.5,1894.04,CRED CREA,Despesas administrativas,Outras,../data/raw/BANCO CRED CREA - 2024.xlsx
2024-08-16,DB. ALLIANZ SEGURO RANGER - 01 DE 10,84624000166,0.0,390.57,1503.47,CRED CREA,Despesas administrativas,Seguro veicular,../data/raw/BANCO CRED CREA - 2024.xlsx
2024-08-16,PG.P/INTERNET - ENERGIA LJ 3,10003415,0.0,211.1,1292.37,CRED CREA,Despesas administrativas,Energia,../data/raw/BANCO CRED CREA - 2024.xlsx
2024-08-16,PG.P/INTERNET - ENERGIA LJ 4,10003427,0.0,67.48,1224.89,CRED CREA,Despesas administrativas,Energia,../data/raw/BANCO CRED CREA - 2024.xlsx
2024-08-16,PG.P/INTERNET - ENERGIA LJ 6,10003439,0.0,553.96,670.93,CRED CREA,Despesas administrativas,Energia,../data/raw/BANCO CRED CREA - 2024.xlsx
2024-01-02,CRED PIX HORFRAN - NF-e 4453,21619,260.0,0.0,"11.799,16",CAIXA,Receita com serviços,,../data/raw/BANCO CAIXA 2024.xlsx
2024-01-03,CRED TED BRASANITAS HOSPITALAR HIGIEN - NFS-e 2429 E NF-e 4443,237,585.0,0.0,"12.384,16",CAIXA,Receita com serviços,Outras,../data/raw/BANCO CAIXA 2024.xlsx
2024-01-05,ENVIO TEV ROBSON - PAGTO DE SALÁRIO,51237,0.0,2145.47,"10.238,69",CAIXA,Despesa com pessoal,Salário,../data/raw/BANCO CAIXA 2024.xlsx
2024-01-05,ENVIO PIX BRENDA - PAGTO DE SALÁRIO,51244,0.0,822.25,"9.416,44",CAIXA,Despesa com pessoal,Salário,../data/raw/BANCO CAIXA 2024.xlsx
2024-01-05,ENVIO PIX CINTHYA - PAGTO DE SALÁRIO,51253,0.0,1353.37,"8.063,07",CAIXA,Despesa com pessoal,Salário,../data/raw/BANCO CAIXA 2024.xlsx
2024-01-05,ENVIO PIX NICOLAS - PAGTO DE SALÁRIO,51256,0.0,1498.9,"6.564,17",CAIXA,Despesa com pessoal,Salário,../data/raw/BANCO CAIXA 2024.xlsx
2024-01-05,ENVIO PIX RONALDO - PAGTO DE SALÁRIO,51303,0.0,957.88,"5.606,29",CAIXA,Despesa com pessoal,Salário,../data/raw/BANCO CAIXA 2024.xlsx
2024-01-05,DB CEST PJ,122023,0.0,69.0,"5.537,29",CAIXA,Despesas financeiras,Outras,../data/raw/BANCO CAIXA 2024.xlsx
2024-01-08,PAG BOLETO ALUGUEL,81520,0.0,4708.01,"829,28",CAIXA,Despesas administrativas,Outras,../data/raw/BANCO CAIXA 2024.xlsx
2024-01-08,PAG FGTS,81524,0.0,427.3,"401,98",CAIXA,Despesa com pessoal,Outras,../data/raw/BANCO CAIXA 2024.xlsx
2024-01-10,CRED TED PANASONIC DO BRASIL LIMITADA NFS-e 2450,341,7721.98,0.0,"8.123,96",CAIXA,Receita com serviços,Outras,../data/raw/BANCO CAIXA 2024.xlsx
2024-01-11,ENVIO PIX CINTHYA - PAGTO DE RESCISÃO,111426,0.0,1464.66,"6.659,30",CAIXA,Despesa com pessoal,Outras,../data/raw/BANCO CAIXA 2024.xlsx
2024-01-19,ENVIO PIX BRENDA - PAGTO ADIANTAMENTO DE SALÁRIO,191504,0.0,696.04,"5.963,26",CAIXA,Despesa com pessoal,Outras,../data/raw/BANCO CAIXA 2024.xlsx
2024-01-19,PG ORG GOV DARF ALUGUEL,191508,0.0,84.58,"5.878,68",CAIXA,Despesas tributárias ,Outras,../data/raw/BANCO CAIXA 2024.xlsx
2024-01-19,PG ORG GOV DARF/INSS,191512,0.0,1519.47,"4.359,21",CAIXA,Despesa com pessoal,Outras,../data/raw/BANCO CAIXA 2024.xlsx
2024-01-19,PG ORG GOV DAS,191516,0.0,2767.23,"1.591,98",CAIXA,Despesas tributárias ,Outras,../data/raw/BANCO CAIXA 2024.xlsx
2024-01-22,CRED TED DAIKIN AR CONDICIONADO BRASIL NFS-e 2458,33,300.0,0.0,"1.891,98",CAIXA,Receita com serviços,Outras,../data/raw/BANCO CAIXA 2024.xlsx
2024-01-22,CRED TED SPRINGER CARRIER LTDA NFS-e 2457,341,6273.75,0.0,"8.165,73",CAIXA,Receita com serviços,Outras,../data/raw/BANCO CAIXA 2024.xlsx
2024-01-31,CRED TED - PAGSEGURO INTERNET LTDA,290,2056.29,0.0,"10.222,02",CAIXA,Outras entradas,Outras,../data/raw/BANCO CAIXA 2024.xlsx
2024-02-01,CRED TED BRASANITAS HOSPITALAR HIGIEN NFS-e 2456 E NF-e 4459,237,1000.0,0.0,"11.222,02",CAIXA,Receita com serviços,Outras,../data/raw/BANCO CAIXA 2024.xlsx
2024-02-05,ENVIO PIX SILVIA - CONTABILIDADE HONORÁRIOS ,52153,0.0,789.45,"10.432,57",CAIXA,Despesas administrativas,Contabilidade,../data/raw/BANCO CAIXA 2024.xlsx
2024-02-05,DB CEST PJ,12024,0.0,69.0,"10.363,57",CAIXA,Despesas financeiras,Despesas bancárias,../data/raw/BANCO CAIXA 2024.xlsx
2024-02-06,ENVIO TEV ROBSON - PAGTO DE SALÁRIO,61117,0.0,2334.11,"8.029,46",CAIXA,Despesa com pessoal,Salário,../data/raw/BANCO CAIXA 2024.xlsx
2024-02-06,ENVIO PIX NICOLAS - PAGTO DE SALÁRIO,61124,0.0,1519.17,"6.510,29",CAIXA,Despesa com pessoal,Salário,../data/raw/BANCO CAIXA 2024.xlsx
2024-02-06,ENVIO PIX RONALDO - PAGTO DE SALÁRIO,61127,0.0,1500.28,"5.010,01",CAIXA,Despesa com pessoal,Salário,../data/raw/BANCO CAIXA 2024.xlsx
2024-02-06,ENVIO PIX THIAGO - PAGTO DE SALÁRIO,61131,0.0,1604.67,"3.405,34",CAIXA,Despesa com pessoal,Salário,../data/raw/BANCO CAIXA 2024.xlsx
2024-02-06,PAG FGTS,61133,0.0,1010.63,"2.394,71",CAIXA,Despesa com pessoal,FGTS,../data/raw/BANCO CAIXA 2024.xlsx
2024-02-14,CRED TED MONTEMOR INVESTIMENTOS E PARTI - NFS-e 2481,341,400.0,0.0,"2.794,71",CAIXA,Receita com serviços,Outras,../data/raw/BANCO CAIXA 2024.xlsx
2024-02-14,CRED TED PANASONIC DO BRASIL LIMITADA -NFS-e 2466,341,4037.37,0.0,"6.832,08",CAIXA,Receita com serviços,Panasonic,../data/raw/BANCO CAIXA 2024.xlsx
2024-02-15,PAG BOLETO CARTÃO AMERICAN,151507,0.0,1530.07,"5.302,01",CAIXA,Despesas administrativas,Outras,../data/raw/BANCO CAIXA 2024.xlsx
2024-02-19,CRED PIX HORFRAN - COMERCIAL ELETRO MOVEIS LTDA NFS-e  2774,191426,150.0,0.0,"5.452,01",CAIXA,Receita com serviços,Outras,../data/raw/BANCO CAIXA 2024.xlsx
2024-02-20,PG ORG GOV DAS,201529,0.0,1858.81,"3.593,20",CAIXA,Despesas tributárias ,Outras,../data/raw/BANCO CAIXA 2024.xlsx
2024-02-20,PG ORG GOV DARF/INSS,201532,0.0,1413.92,"2.179,28",CAIXA,Despesa com pessoal,INSS,../data/raw/BANCO CAIXA 2024.xlsx
2024-02-20,ENVIO PIX LUIZ - ADIANTAMENTO QUINZENAL,201535,0.0,800.0,"1.379,28",CAIXA,Despesa com pessoal,Salário,../data/raw/BANCO CAIXA 2024.xlsx
2024-02-20,CRED TED SPRINGER CARRIER LTDA NFS-e 2482,341,7061.32,0.0,"8.440,60",CAIXA,Receita com serviços,Panasonic,../data/raw/BANCO CAIXA 2024.xlsx
2024-02-20,PAG BOLETO CARTÃO INTER,201546,0.0,5275.53,"3.165,07",CAIXA,Despesas administrativas,Outras,../data/raw/BANCO CAIXA 2024.xlsx
2024-02-21,CRED TED FRESNOMAQ INDUSTRIA DE MAQUINA NFS-e 2478,341,2255.0,0.0,"5.420,07",CAIXA,Receita com serviços,Panasonic,../data/raw/BANCO CAIXA 2024.xlsx
2024-02-27,CRED PIX HORFRAN - COMERCIAL ELETRO MOVEIS LTDA NFS-e  2475,271523,280.0,0.0,"5.700,07",CAIXA,Receita com serviços,Outras,../data/raw/BANCO CAIXA 2024.xlsx
2024-02-28,CRED PIX HORFRAN - COMERCIAL ELETRO MOVEIS LTDA NFS-e  4480,281606,215.0,0.0,"5.915,07",CAIXA,Receita com serviços,Outras,../data/raw/BANCO CAIXA 2024.xlsx
2024-03-04,CRED TED LOJAS COLOMBO NFS-e 2486,422,450.0,0.0,"6.365,07",CAIXA,Receita com serviços,Outras,../data/raw/BANCO CAIXA 2024.xlsx
2024-03-05,DB CEST PJ,22024,0.0,69.0,"6.296,07",CAIXA,Despesas financeiras,Despesas bancárias,../data/raw/BANCO CAIXA 2024.xlsx
2024-03-06,ENVIO TEV ROBSON FERNANDES - PAGTO DE SALÁRIO,61206,0.0,2409.51,"3.886,56",CAIXA,Despesa com pessoal,Salário,../data/raw/BANCO CAIXA 2024.xlsx
2024-03-06,CRED TED - PAGSEGURO INTERNET LTDA,290,483.0,0.0,"4.369,56",CAIXA,Outras entradas,Outras,../data/raw/BANCO CAIXA 2024.xlsx
2024-03-06,ENVIO PIX RONALDO - PAGTO DE SALÁRIO,61518,0.0,1503.47,"2.866,09",CAIXA,Despesa com pessoal,Salário,../data/raw/BANCO CAIXA 2024.xlsx
2024-03-06,ENVIO PIX NICOLAS - PAGTO DE SALÁRIO,61521,0.0,632.24,"2.233,85",CAIXA,Despesa com pessoal,Salário,../data/raw/BANCO CAIXA 2024.xlsx
2024-03-06,ENVIO PIX LUIZ GUILHERME - PAGTO DE SALÁRIO,61607,0.0,1301.87,"931,98",CAIXA,Despesa com pessoal,Salário,../data/raw/BANCO CAIXA 2024.xlsx
2024-03-06,PAG FGTS,61611,0.0,893.24,"38,74",CAIXA,Despesa com pessoal,FGTS,../data/raw/BANCO CAIXA 2024.xlsx
2024-03-11,CRED TED PANASONIC DO BRASIL LIMITADA - NFS-e 2488,341,10131.6,0.0,"10.170,34",CAIXA,Receita com serviços,Panasonic,../data/raw/BANCO CAIXA 2024.xlsx
2024-03-15,PAG BOLETO PARANÁ CLINICAS,151710,0.0,1069.79,"9.100,55",CAIXA,Despesa com pessoal,Assistência médica,../data/raw/BANCO CAIXA 2024.xlsx
2024-03-20,PG ORG GOV DAS,201511,0.0,2414.58,"6.685,97",CAIXA,Despesas tributárias ,Outras,../data/raw/BANCO CAIXA 2024.xlsx
2024-03-20,PG ORG GOV DARF/INSS,201514,0.0,1298.23,"5.387,74",CAIXA,Despesa com pessoal,INSS,../data/raw/BANCO CAIXA 2024.xlsx
2024-03-20,PAG BOLETO CARTÃO INTER,201521,0.0,2799.92,"2.587,82",CAIXA,Despesas administrativas,Outras,../data/raw/BANCO CAIXA 2024.xlsx
2024-03-20,ENVIO PIX LUIZ - ADIANTAMENTO QUINZENAL,201552,0.0,800.0,"1.787,82",CAIXA,Despesa com pessoal,Salário,../data/raw/BANCO CAIXA 2024.xlsx
2024-03-20,CRED TED SPRINGER CARRIER LTDA NFS-e 2497,341,3231.24,0.0,"5.019,06",CAIXA,Receita com serviços,Panasonic,../data/raw/BANCO CAIXA 2024.xlsx
2024-03-25,CRED TED DAIKIN AR CONDICIONADO BRASIL NFS-e 2499,33,150.0,0.0,"5.169,06",CAIXA,Receita com serviços,Outras,../data/raw/BANCO CAIXA 2024.xlsx
2024-04-05,ENVIO TEV ROBSON - PAGTO DE SALÁRIO,51257,0.0,2583.37,"2.585,69",CAIXA,Despesa com pessoal,Salário,../data/raw/BANCO CAIXA 2024.xlsx
2024-04-05,DB CEST PJ,32024,0.0,69.0,"2.516,69",CAIXA,Despesas financeiras,Despesas bancárias,../data/raw/BANCO CAIXA 2024.xlsx
2024-04-08,ENVIO PIX ROBSON - PAGTO DE FÉRIAS,81454,0.0,1678.01,"838,68",CAIXA,Despesa com pessoal,Salário,../data/raw/BANCO CAIXA 2024.xlsx
2024-04-08,PAG BOLETO CIEE - ESTAGIÁRIO KAIO,81809,0.0,550.19,"288,49",CAIXA,Despesa com pessoal,Salário,../data/raw/BANCO CAIXA 2024.xlsx
2024-04-10,CRED TED PANASONIC DO BRASIL LIMITADA NFS-e 2506,341,7455.25,0.0,"7.743,74",CAIXA,Receita com serviços,Panasonic,../data/raw/BANCO CAIXA 2024.xlsx
2024-04-15,PAG BOLETO CARTÃO AMERICAN,151109,0.0,2070.26,"5.673,48",CAIXA,Despesas administrativas,Outras,../data/raw/BANCO CAIXA 2024.xlsx
2024-04-17,CRED PIX MONTEMOR INVESTIMENTOS E PARTICIPACOES S A,170102,480.0,0.0,"6.153,48",CAIXA,Receita com serviços,Outras,../data/raw/BANCO CAIXA 2024.xlsx
2024-04-19,ENVIO PIX LUIZ - PAGTO ADIANTAMENTO QUINZENAL,191217,0.0,838.88,"5.314,60",CAIXA,Despesa com pessoal,Salário,../data/raw/BANCO CAIXA 2024.xlsx
2024-04-19,PG ORG GOV DARF/INSS,191228,0.0,1477.01,"3.837,59",CAIXA,Despesa com pessoal,INSS,../data/raw/BANCO CAIXA 2024.xlsx
2024-04-19,PG ORG GOV DAS,191744,0.0,1830.73,"2.006,86",CAIXA,Despesas tributárias ,Outras,../data/raw/BANCO CAIXA 2024.xlsx
2024-04-22,CRED TED SPRINGER CARRIER LTDA NFS-e 2517,341,4545.0,0.0,"6.551,86",CAIXA,Receita com serviços,Panasonic,../data/raw/BANCO CAIXA 2024.xlsx
2024-05-03,CRED TED FRESNOMAQ INDUSTRIA DE MAQUINA NFS-e 2518,341,1967.5,0.0,"8.519,36",CAIXA,Receita com serviços,Panasonic,../data/raw/BANCO CAIXA 2024.xlsx
2024-05-06,ENVIO PIX PAGTO HONORÁRIOS CONTABILIDADE,61500,0.0,559.45,"7.959,91",CAIXA,Despesas administrativas,Contabilidade,../data/raw/BANCO CAIXA 2024.xlsx
2024-05-06,ENVIO PIX SIMONE - PAGTO SERVIÇOS PRESTADO,61722,0.0,619.0,"7.340,91",CAIXA,Despesa com serviços,Mão de obra,../data/raw/BANCO CAIXA 2024.xlsx
2024-05-06,DB CEST PJ,42024,0.0,69.0,"7.271,91",CAIXA,Despesas financeiras,Despesas bancárias,../data/raw/BANCO CAIXA 2024.xlsx
2024-05-07,ENVIO PIX LUIZ GUILHERME KRAUSE - PAGTO DE SALÁRIO,71219,0.0,1476.99,"5.794,92",CAIXA,Despesa com pessoal,Salário,../data/raw/BANCO CAIXA 2024.xlsx
2024-05-07,ENVIO PIX ROBSON FERNANDES - PAGTO DE SALÁRIO,71223,0.0,1058.62,"4.736,30",CAIXA,Despesa com pessoal,Salário,../data/raw/BANCO CAIXA 2024.xlsx
2024-05-07,ENVIO PIX ROBSON FERNANDES - COMPRA DE PLACA PARA TV ECEEL,71833,0.0,800.0,"3.936,30",CAIXA,Despesas administrativas,Outras,../data/raw/BANCO CAIXA 2024.xlsx
2024-05-10,CRED TED PANASONIC DO BRASIL LIMITADA NFS-e 2524,341,12224.07,0.0,"16.160,37",CAIXA,Receita com serviços,Panasonic,../data/raw/BANCO CAIXA 2024.xlsx
2024-05-13,PAG BOLETO SPRINGER CARRIER,131613,0.0,214.88,"15.945,49",CAIXA,Despesa com serviços,Spring,../data/raw/BANCO CAIXA 2024.xlsx
2024-05-15,CRED TED BRASANITAS HOSPITALAR HIGIEN -NFS 2495 E NF-e 4504,237,1200.0,0.0,"17.145,49",CAIXA,Receita com serviços,Outras,../data/raw/BANCO CAIXA 2024.xlsx
2024-05-15,PAG BOLETO PARANÁ CLINICAS - PLANOS SAÚDE,151612,0.0,1069.79,"16.075,70",CAIXA,Despesa com pessoal,Assistência médica,../data/raw/BANCO CAIXA 2024.xlsx
2024-05-15,PAG BOLETO CARTÃO AMEX,151608,0.0,3281.19,"12.794,51",CAIXA,Despesas administrativas,Outras,../data/raw/BANCO CAIXA 2024.xlsx
2024-05-15,ENVIO PIX CLAUDIO PRO-LABORE REF. À MARÇO C/ VENC EM ABRIL,151616,0.0,1352.8,"11.441,71",CAIXA,Despesa com pessoal,Pró labore,../data/raw/BANCO CAIXA 2024.xlsx
2024-05-15,ENVIO PIX ELISABETE PRO-LABORE REF. À MARÇO C/ VENC EM ABRIL,151618,0.0,1352.8,"10.088,91",CAIXA,Despesa com pessoal,Pró labore,../data/raw/BANCO CAIXA 2024.xlsx
2024-05-15,ENVIO PIX PAGTO ENERGIA LJ3,151622,0.0,162.14,"9.926,77",CAIXA,Despesas administrativas,Energia,../data/raw/BANCO CAIXA 2024.xlsx
2024-05-15,ENVIO PIX PAGTO ENERGIA LJ4,151626,0.0,55.82,"9.870,95",CAIXA,Despesas administrativas,Energia,../data/raw/BANCO CAIXA 2024.xlsx
2024-05-15,ENVIO PIX PAGTO ENERGIA LJ6,151628,0.0,380.19,"9.490,76",CAIXA,Despesas administrativas,Energia,../data/raw/BANCO CAIXA 2024.xlsx
2024-05-15,CRED PIX HORFRAN - NFS-e 2483,151742,180.0,0.0,"9.670,76",CAIXA,Receita com serviços,Outras,../data/raw/BANCO CAIXA 2024.xlsx
2024-05-16,CRED PIX HORFRAN - NF-e 4510,161618,90.0,0.0,"9.760,76",CAIXA,Receita com serviços,Outras,../data/raw/BANCO CAIXA 2024.xlsx
2024-05-20,CRED TED BRASANITAS HOSPITALAR HIGIEN NFS-e 2494,237,450.0,0.0,"10.210,76",CAIXA,Receita com serviços,Outras,../data/raw/BANCO CAIXA 2024.xlsx
2024-05-20,CRED TED SPRINGER CARRIER LTDA NFS-e 2534,341,11993.6,0.0,"22.204,36",CAIXA,Receita com serviços,Panasonic,../data/raw/BANCO CAIXA 2024.xlsx
2024-05-20,ENVIO PIX LUIZ GUILHERME - PAGTO ADIANTAMENTO QUINZENAL,201615,0.0,838.88,"21.365,48",CAIXA,Despesa com pessoal,Salário,../data/raw/BANCO CAIXA 2024.xlsx
2024-05-20,PG ORG GOV DARF/INSS,201622,0.0,1492.23,"19.873,25",CAIXA,Despesa com pessoal,INSS,../data/raw/BANCO CAIXA 2024.xlsx
2024-05-20,PG ORG GOV DAS,201627,0.0,2598.44,"17.274,81",CAIXA,Despesas tributárias ,Outras,../data/raw/BANCO CAIXA 2024.xlsx
2024-05-20,ENVIO PIX FGTS,201632,0.0,1054.65,"16.220,16",CAIXA,Despesa com pessoal,FGTS,../data/raw/BANCO CAIXA 2024.xlsx
2024-05-20,ENVIO PIX GOVERNO DO PARANA - IPVA/2024 RANGER- 5 DE 5,201651,0.0,975.62,"15.244,54",CAIXA,Despesas tributárias ,IPVA,../data/raw/BANCO CAIXA 2024.xlsx
2024-05-20,ENVIO PIX GOVERNO DO PARANA -IPVA/2024 FIESTA - 5 DE 5,201652,0.0,113.84,"15.130,70",CAIXA,Despesas tributárias ,IPVA,../data/raw/BANCO CAIXA 2024.xlsx
2024-05-21,CRED PIX HORFRAN - NFS-e 2523 E NF-e 4548,211607,380.0,0.0,"15.510,70",CAIXA,Receita com serviços,Outras,../data/raw/BANCO CAIXA 2024.xlsx
2024-05-22,CRED TED FRESNOMAQ INDUSTRIA DE MAQUINA NFS-e 2531,341,3170.0,0.0,"18.680,70",CAIXA,Receita com serviços,Panasonic,../data/raw/BANCO CAIXA 2024.xlsx
2024-05-27,CRED TED LOJAS COLOMBO - NFS-e 2541,422,110.0,0.0,"18.790,70",CAIXA,Receita com serviços,Outras,../data/raw/BANCO CAIXA 2024.xlsx
2024-05-27,CRED PIX HORFRAN - NFS-e 2538,271638,280.0,0.0,"19.070,70",CAIXA,Receita com serviços,Outras,../data/raw/BANCO CAIXA 2024.xlsx
2024-05-28,CRED PIX HORFRAN - NFS-e 2536,281049,100.0,0.0,"19.170,70",CAIXA,Receita com serviços,Outras,../data/raw/BANCO CAIXA 2024.xlsx
2024-05-29,CRED PIX HORFRAN - NF-e 4557,291631,40.0,0.0,"19.210,70",CAIXA,Receita com serviços,Outras,../data/raw/BANCO CAIXA 2024.xlsx
2024-05-31,ENVIO PIX KAIO  SPURI LIMA - PAGTO DE VT ESTAGIÁRIO,311847,0.0,240.0,"18.970,70",CAIXA,Despesa com pessoal,Transporte (VT),../data/raw/BANCO CAIXA 2024.xlsx
2024-05-31,ENVIO PIX ELISABETE PRO-LABORE REF. À ABRIL C/ VENC EM MAIO,311851,0.0,1352.8,"17.617,90",CAIXA,Despesa com pessoal,Pró labore,../data/raw/BANCO CAIXA 2024.xlsx
2024-05-31,ENVIO PIX CLAUDIO PRO-LABORE REF. À ABRIL C/ VENC EM MAIO,311853,0.0,1352.8,"16.265,10",CAIXA,Despesa com pessoal,Pró labore,../data/raw/BANCO CAIXA 2024.xlsx
2024-06-03,PAG BOLETO SPRINGER CARRIER - 1 DE 2 PARCELAS,31523,0.0,376.66,"15.888,44",CAIXA,Despesa com serviços,Spring,../data/raw/BANCO CAIXA 2024.xlsx
2024-06-03,ENVIO PIX GOVERNO DO PARANA SECRETARIA DE ESTADO DA FAZENDA-GRPR,31529,0.0,211.24,"15.677,20",CAIXA,Despesas tributárias ,Outras,../data/raw/BANCO CAIXA 2024.xlsx
2024-06-05,PAG CONTA DE ÁGUA,51856,0.0,226.75,"15.450,45",CAIXA,Despesas administrativas,Água,../data/raw/BANCO CAIXA 2024.xlsx
2024-06-05,ENVIO PIX SIMONE - SERVIÇOS PRESTADO,51859,0.0,577.0,"14.873,45",CAIXA,Despesa com serviços,Mão de obra,../data/raw/BANCO CAIXA 2024.xlsx
2024-06-05,ENVIO PIX PAGTO HONORÁRIOS CONTABILIDADE,51903,0.0,559.45,"14.314,00",CAIXA,Despesas administrativas,Contabilidade,../data/raw/BANCO CAIXA 2024.xlsx
2024-06-05,DB CEST PJ,52024,0.0,69.0,"14.245,00",CAIXA,Despesas financeiras,Despesas bancárias,../data/raw/BANCO CAIXA 2024.xlsx
2024-06-06,ENVIO PIX JUAN V MARTINS - PAGTO VALE TRANSPORTE,61200,0.0,240.0,"14.005,00",CAIXA,Despesa com pessoal,Transporte (VT),../data/raw/BANCO CAIXA 2024.xlsx
2024-06-06,ENVIO TEV ROBSON FERNANDES - PAGTO DE SALÁRIO,61223,0.0,2436.31,"11.568,69",CAIXA,Despesa com pessoal,Salário,../data/raw/BANCO CAIXA 2024.xlsx
2024-06-06,ENVIO PIX LUIZ GUILHERME - PAGTO DE SALÁRIO,61237,0.0,1561.73,"10.006,96",CAIXA,Despesa com pessoal,Salário,../data/raw/BANCO CAIXA 2024.xlsx
2024-06-06,ENVIO PIX NICOLAS - PAGTO DE SALÁRIO,61240,0.0,1465.32,"8.541,64",CAIXA,Despesa com pessoal,Salário,../data/raw/BANCO CAIXA 2024.xlsx
2024-06-06,ENVIO PIX RONALDO - PAGTO DE SALÁRIO,61243,0.0,1642.34,"6.899,30",CAIXA,Despesa com pessoal,Salário,../data/raw/BANCO CAIXA 2024.xlsx
2024-06-07,PAG BOLETO CIEE - ESTAGIÁRIO,71531,0.0,550.19,"6.349,11",CAIXA,Despesa com pessoal,Salário,../data/raw/BANCO CAIXA 2024.xlsx
2024-06-10,CRED TED PANASONIC DO BRASIL LIMITADA - NFS-e 2543,341,7704.82,0.0,"14.053,93",CAIXA,Receita com serviços,Panasonic,../data/raw/BANCO CAIXA 2024.xlsx
2024-06-10,PAG BOLETO ALUGUEL,101029,0.0,4993.82,"9.060,11",CAIXA,Despesas administrativas,Aluguel imóvel,../data/raw/BANCO CAIXA 2024.xlsx
2024-06-10,PAG BOLETO WHITE MARTINS,101033,0.0,48.42,"9.011,69",CAIXA,Despesa com produtos,Materiais de Consumo,../data/raw/BANCO CAIXA 2024.xlsx
2024-06-10,PAG BOLETO REFRIGERAÇÃO DUFRIO,101036,0.0,311.22,"8.700,47",CAIXA,Despesa com serviços,Outras,../data/raw/BANCO CAIXA 2024.xlsx
2024-06-14,PAG BOLETO CARTÃO AMERICAN,141953,0.0,2469.02,"6.231,45",CAIXA,Despesas administrativas,Outras,../data/raw/BANCO CAIXA 2024.xlsx
2024-06-20,ENVIO PIX PAGTO FGTS,201129,0.0,1074.45,"5.157,00",CAIXA,Despesa com pessoal,FGTS,../data/raw/BANCO CAIXA 2024.xlsx
2024-06-20,PG ORG GOV DAS,201137,0.0,2683.2,"2.473,80",CAIXA,Despesas tributárias ,Outras,../data/raw/BANCO CAIXA 2024.xlsx
2024-06-20,PG ORG GOV DARF/INSS,201141,0.0,1485.73,"988,07",CAIXA,Despesa com pessoal,INSS,../data/raw/BANCO CAIXA 2024.xlsx
2024-06-20,PAG BOLETO SELETROAR - CONTRIBUIÇÃO ASSISTENCIAL DOS FUNCIONÁRIOS,201205,0.0,150.0,"838,07",CAIXA,Despesa com pessoal,Outras,../data/raw/BANCO CAIXA 2024.xlsx
2024-06-20,PAG BOLETO SPRINGER CARRIER NF 827546 - 1 DE 3,201209,0.0,428.12,"409,95",CAIXA,Despesa com serviços,Spring,../data/raw/BANCO CAIXA 2024.xlsx
2024-06-20,CRED TED SPRINGER CARRIER LTDA NFS-e 2554,341,5255.16,0.0,"5.665,11",CAIXA,Receita com serviços,Panasonic,../data/raw/BANCO CAIXA 2024.xlsx
2024-06-21,CRED TED FRESNOMAQ INDUSTRIA DE MAQUINA NFS-e 2550,341,1365.0,0.0,"7.030,11",CAIXA,Receita com serviços,Panasonic,../data/raw/BANCO CAIXA 2024.xlsx
2024-06-26,ENVIO PIX LUIZ GUILHERME - PAGTO RESCISÃO DO CONTRATO DE TRABALHO,260927,0.0,2723.07,"4.307,04",CAIXA,Despesa com pessoal,Aviso prévio / Multa rescisória,../data/raw/BANCO CAIXA 2024.xlsx
2024-06-27,CRED PIX MAI TERRACES - NF-e 4583,270403,1100.0,0.0,"5.407,04",CAIXA,Receita com serviços,Outras,../data/raw/BANCO CAIXA 2024.xlsx
2024-07-01,CRED PIX STONE PAGAMENTOS-MAQUININHA TON,11407,1428.33,0.0,"6.835,37",CAIXA,Receita com serviços,Outras,../data/raw/BANCO CAIXA 2024.xlsx
2024-07-03,ENVIO PIX GOVERNO DO PARANA SECRETARIA DE ESTADO DA FAZENDA-GRPR,31134,0.0,657.14,"6.178,23",CAIXA,Despesas tributárias ,Outras,../data/raw/BANCO CAIXA 2024.xlsx
2024-07-03,CRED PIX HORFRAN - NF-e 4577 - NF-e 45 e NFS-e 2555,31627,1250.0,0.0,"7.428,23",CAIXA,Receita com serviços,Outras,../data/raw/BANCO CAIXA 2024.xlsx
2024-07-05,   ENVIO TEV ROBSON FERNANDES - PAGTO DE SALÁRIO,51134,0.0,2806.33,"4.621,90",CAIXA,Despesa com pessoal,Salário,../data/raw/BANCO CAIXA 2024.xlsx
2024-07-05,ENVIO PIX RONALDO - PAGTO DE SALÁRIO,51139,0.0,1676.89,"2.945,01",CAIXA,Despesa com pessoal,Salário,../data/raw/BANCO CAIXA 2024.xlsx
2024-07-05,ENVIO PIX THIAGO - PAGTO DE SALÁRIO,51141,0.0,1625.1,"1.319,91",CAIXA,Despesa com pessoal,Salário,../data/raw/BANCO CAIXA 2024.xlsx
2024-07-05,ENVIO PIX PAGTO HONORÁRIOS CONTABILIDADE,51144,0.0,559.45,"760,46",CAIXA,Despesas administrativas,Contabilidade,../data/raw/BANCO CAIXA 2024.xlsx
2024-07-05,DB CEST PJ,62024,0.0,69.0,"691,46",CAIXA,Despesas financeiras,Despesas bancárias,../data/raw/BANCO CAIXA 2024.xlsx
2024-07-10,CRED TED PANASONIC DO BRASIL LIMITADA - NFS-e 2569,341,6578.72,0.0,"7.270,18",CAIXA,Receita com serviços,Panasonic,../data/raw/BANCO CAIXA 2024.xlsx
2024-07-12,CRED TED PANASONIC DO BRASIL LIMITADA - NFS-e 2569,121711,360.0,0.0,"7.630,18",CAIXA,Receita com serviços,Panasonic,../data/raw/BANCO CAIXA 2024.xlsx
2024-07-15,CRED PIX MAI TERRACES - NFS-e 2564,150437,750.0,0.0,"8.380,18",CAIXA,Receita com serviços,Outras,../data/raw/BANCO CAIXA 2024.xlsx
2024-07-15,PAG BOLETO CARTÃO AMEX,151226,0.0,2646.03,"5.734,15",CAIXA,Despesas administrativas,Outras,../data/raw/BANCO CAIXA 2024.xlsx
2024-07-15,ENVIO PIX CLAUDIO - PAGTO PRO-LABORE,151228,0.0,1352.8,"4.381,35",CAIXA,Despesa com pessoal,Pró labore,../data/raw/BANCO CAIXA 2024.xlsx
2024-07-17,CRED PIX HORFRAN - NFS-e 2573 E NF-e 4591,171443,760.0,0.0,"5.141,35",CAIXA,Receita com serviços,Outras,../data/raw/BANCO CAIXA 2024.xlsx
2024-07-19,ENVIO PIX PAGTO FGTS,191518,0.0,1019.84,"4.121,51",CAIXA,Despesa com pessoal,FGTS,../data/raw/BANCO CAIXA 2024.xlsx
2024-07-19,PG ORG GOV DARF/INSS,191525,0.0,1464.58,"2.656,93",CAIXA,Despesa com pessoal,INSS,../data/raw/BANCO CAIXA 2024.xlsx
2024-07-19,PG ORG GOV DAS,191529,0.0,2131.88,"525,05",CAIXA,Despesas tributárias ,Outras,../data/raw/BANCO CAIXA 2024.xlsx
2024-07-22,CRED TED SPRINGER CARRIER LTDA NFS-e 2582,341,7481.22,0.0,"8.006,27",CAIXA,Receita com serviços,Panasonic,../data/raw/BANCO CAIXA 2024.xlsx
2024-07-22,CRED TED FRESNOMAQ INDUSTRIA DE MAQUINA NFS-e 2578,341,2082.27,0.0,"10.088,54",CAIXA,Receita com serviços,Panasonic,../data/raw/BANCO CAIXA 2024.xlsx
2024-07-25,ENVIO PIX ELISABETE - PAGTO PRO-LABORE,251943,0.0,1352.8,"8.735,74",CAIXA,Despesa com pessoal,Pró labore,../data/raw/BANCO CAIXA 2024.xlsx
2024-07-26,ENVIO PIX TYFFANNE - PAGTO DE RESCISÃO DE CONTRATO,261713,0.0,426.81,"8.308,93",CAIXA,Despesa com pessoal,Aviso prévio / Multa rescisória,../data/raw/BANCO CAIXA 2024.xlsx
2024-07-29,CRED PIX HORFRAN - NFS-e 2584,291525,180.0,0.0,"8.488,93",CAIXA,Receita com serviços,Outras,../data/raw/BANCO CAIXA 2024.xlsx
2024-07-30,CRED PIX HORFRAN - NF-e 4609,301511,95.0,0.0,"8.583,93",CAIXA,Receita com serviços,Outras,../data/raw/BANCO CAIXA 2024.xlsx
2024-08-02,PAG BOLETO URBS - VALE TRANSPORTE - MARCOS,20940,0.0,267.03,"8.316,90",CAIXA,Despesa com pessoal,Transporte (VT),../data/raw/BANCO CAIXA 2024.xlsx
2024-08-05,ENVIO PIX PAGTO CONTA DE ÁGUA,51139,0.0,232.24,"8.084,66",CAIXA,Despesas administrativas,Água,../data/raw/BANCO CAIXA 2024.xlsx
2024-08-05,ENVIO PIX GOVERNO DO PARANA SECRETARIA DE ESTADO DA FAZENDA-GRPR,51141,0.0,633.12,"7.451,54",CAIXA,Despesas tributárias ,Outras,../data/raw/BANCO CAIXA 2024.xlsx
2024-08-05,ENVIO PIX PAGTO HONORÁRIOS CONTABILIDADE,51153,0.0,559.45,"6.892,09",CAIXA,Despesas administrativas,Contabilidade,../data/raw/BANCO CAIXA 2024.xlsx
2024-08-05,DB CEST PJ,72024,0.0,69.0,"6.823,09",CAIXA,Despesas financeiras,Despesas bancárias,../data/raw/BANCO CAIXA 2024.xlsx
2024-08-06,ENVIO PIX NICOLAS - PAGTO DE SALÁRIO,61033,0.0,1645.26,"5.177,83",CAIXA,Despesa com pessoal,Salário,../data/raw/BANCO CAIXA 2024.xlsx
2024-08-06,ENVIO PIX THIAGO - PAGTO DE SALÁRIO,61038,0.0,1617.1,"3.560,73",CAIXA,Despesa com pessoal,Salário,../data/raw/BANCO CAIXA 2024.xlsx
2024-08-06,ENVIO PIX RONALDO - PAGTO DE SALÁRIO,61041,0.0,1726.23,"1.834,50",CAIXA,Despesa com pessoal,Salário,../data/raw/BANCO CAIXA 2024.xlsx
2024-08-07,PAG BOLETO VR BENEFICIOS E SERV. DE PROC. - P/ MARCOS,71627,0.0,200.0,"1.634,50",CAIXA,Despesa com pessoal,Alimentação (VR VA),../data/raw/BANCO CAIXA 2024.xlsx
2024-08-07,ENVIO PIX ROBSON-REEMBOLSO DE DESPESAS C/ COMBUSTÍVEL E ALIM. REF. HORAS EXTRAS,71632,0.0,245.0,"1.389,50",CAIXA,Despesa com pessoal,Alimentação (VR VA),../data/raw/BANCO CAIXA 2024.xlsx
2024-08-09,PAG BOLETO CIEE - PAGTO ESTAGIÁRIO KAIO,91131,0.0,550.19,"839,31",CAIXA,Despesa com pessoal,Salário,../data/raw/BANCO CAIXA 2024.xlsx
2024-08-12,PAG BOLETO CARTÃO PORTO SEGURO - PEDÁGIOS,121509,0.0,114.73,"724,58",CAIXA,Despesa com serviços,Transporte,../data/raw/BANCO CAIXA 2024.xlsx
2024-08-12,CRED TED PANASONIC DO BRASIL LIMITADA - NFS-e 2585,341,2990.95,0.0,"3.715,53",CAIXA,Receita com serviços,Panasonic,../data/raw/BANCO CAIXA 2024.xlsx
2023-01-03,PIX RECEBIDO FÁBIO DE SOUSA SOBRINHO,,430.0,0.0,2019.08,INTER,Receita com serviços,Outras,../data/raw/BANCO INTER-2023.xlsx
2023-01-03,PIX RECEBIDO WELLINGTON VICENTE DE PAULA AGUIAR,,115.0,0.0,2134.08,INTER,Receita com serviços,Outras,../data/raw/BANCO INTER-2023.xlsx
2023-01-06,PIX ENVIADO TATYANA CHAVIER - PAGTO DE SALÁRIO,,0.0,1140.63,993.45,INTER,Despesa com pessoal,Salário,../data/raw/BANCO INTER-2023.xlsx
2023-01-06,PIX ENVIADO LAURA AZEVEDO RODA - PAGTO DE SALÁRIO,,0.0,736.52,256.93,INTER,Despesa com pessoal,Salário,../data/raw/BANCO INTER-2023.xlsx
2023-01-06,PIX RECEBIDO FERNANDA DA VEIGA LIMA,,100.0,0.0,356.93,INTER,Receita com serviços,Outras,../data/raw/BANCO INTER-2023.xlsx
2023-01-09,PIX RECEBIDO RICARDO TADEU STUMPF TONIN,,85.25,0.0,442.18,INTER,Receita com serviços,Outras,../data/raw/BANCO INTER-2023.xlsx
2023-01-11,PIX RECEBIDO ROSIMERI MEURER,,440.0,0.0,882.18,INTER,Receita com serviços,Outras,../data/raw/BANCO INTER-2023.xlsx
2023-01-11,PIX RECEBIDO RENATA VIVIANE GONCALVES PEDROSO DA S,,140.0,0.0,1022.18,INTER,Receita com serviços,Outras,../data/raw/BANCO INTER-2023.xlsx
2023-01-12,PIX RECEBIDO JOAO ROBERTO BALDASSO BOSSA,,55.0,0.0,1077.18,INTER,Receita com serviços,Outras,../data/raw/BANCO INTER-2023.xlsx
2023-01-12,PIX RECEBIDO JOSYANE WILLAIN ROCHA PEREIRA,,30.0,0.0,1107.18,INTER,Receita com serviços,Outras,../data/raw/BANCO INTER-2023.xlsx
2023-01-13,PIX RECEBIDO GUSTAVO SANCHES DA COSTA,,320.0,0.0,1427.18,INTER,Receita com serviços,Outras,../data/raw/BANCO INTER-2023.xlsx
2023-01-13,PIX RECEBIDO GIOVANA ANDREA C FABIANI,,340.0,0.0,1767.18,INTER,Receita com serviços,Outras,../data/raw/BANCO INTER-2023.xlsx
2023-01-13,PIX RECEBIDO SABRINA DA SILVA,,120.0,0.0,1887.18,INTER,Receita com serviços,Outras,../data/raw/BANCO INTER-2023.xlsx
2023-01-16,PIX RECEBIDO RICARDO TADEU STUMPF TONIN,,85.25,0.0,1972.43,INTER,Receita com serviços,Outras,../data/raw/BANCO INTER-2023.xlsx
2023-01-16,PIX RECEBIDO LUCIENE PIMENTEL DA SILVA,,200.0,0.0,2172.43,INTER,Receita com serviços,Outras,../data/raw/BANCO INTER-2023.xlsx
2023-01-16,PIX RECEBIDO INNOVE T P LTDA - ME,,500.0,0.0,2672.43,INTER,Receita com serviços,Outras,../data/raw/BANCO INTER-2023.xlsx
2023-01-16,PIX ENVIADO JACLEILSON - PAGTO DE VR,,0.0,261.76,2410.67,INTER,Despesa com pessoal,Alimentação (VR VA),../data/raw/BANCO INTER-2023.xlsx
2023-01-17,PIX RECEBIDO VINICIUS VEIVERBERG DILL,,255.0,0.0,2665.67,INTER,Receita com serviços,Outras,../data/raw/BANCO INTER-2023.xlsx
2023-01-17,COMPRA CARTÃO MATERIAL CONSTRUÇÃO VILA IZABEL,,0.0,21.0,2644.67,INTER,Despesas administrativas,Manutenção predial,../data/raw/BANCO INTER-2023.xlsx
2023-01-18,PIX RECEBIDO ELIANE OLIARSKI DA ROCHA,,990.0,0.0,3634.67,INTER,Receita com serviços,Outras,../data/raw/BANCO INTER-2023.xlsx
2023-01-19,DEPOSITO EM CHEQUE JONAS - REF. OS 23/121 ,,618.0,0.0,4252.67,INTER,Receita com serviços,Outras,../data/raw/BANCO INTER-2023.xlsx
2023-01-19,PIX ENVIADO LUIZ CARLOS MARIANO-DEV. PIX REC. 21/11/22,,0.0,22.5,4230.17,INTER,Transferência (Débito),Transferência / Reembolso,../data/raw/BANCO INTER-2023.xlsx
2023-01-20,PIX ENVIADO OSIEL - PAGTO DE COMBUSTÍVEL,,0.0,56.7,4173.47,INTER,Despesas administrativas,Combustivel,../data/raw/BANCO INTER-2023.xlsx
2023-01-23,PIX RECEBIDO SILVANA NEUMANN ALVES,,200.0,0.0,4373.47,INTER,Receita com serviços,Outras,../data/raw/BANCO INTER-2023.xlsx
2023-01-23,PIX RECEBIDO MARIO ANTONIO DOS S BRUSCO,,460.0,0.0,4833.47,INTER,Receita com serviços,Outras,../data/raw/BANCO INTER-2023.xlsx
2023-01-24,PIX RECEBIDO RAQUEL MORAES AGHIARIAN,,340.0,0.0,5173.47,INTER,Receita com serviços,Outras,../data/raw/BANCO INTER-2023.xlsx
2023-01-24,CASHBACK CARTÃO DE CRÉDITO,,6.41,0.0,5179.88,INTER,Transferência (Crédito),Outras,../data/raw/BANCO INTER-2023.xlsx
2023-01-25,PIX RECEBIDO JACKSON ROGERIO BAEZA,,60.0,0.0,5239.88,INTER,Receita com serviços,Outras,../data/raw/BANCO INTER-2023.xlsx
2023-01-26,PIX RECEBIDO ETELVINA MARIA C TRINDADE,,42.5,0.0,5282.38,INTER,Receita com serviços,Outras,../data/raw/BANCO INTER-2023.xlsx
2023-01-26,PIX RECEBIDO MARIA TEREZA FERNANDES ABRAHAO,,240.0,0.0,5522.38,INTER,Receita com serviços,Outras,../data/raw/BANCO INTER-2023.xlsx
2023-01-26,PIX ENVIADO CLAUDIO VINICIUS GALINDO,,0.0,900.0,4622.38,INTER,Despesa com pessoal,Salário,../data/raw/BANCO INTER-2023.xlsx
2023-01-27,PIX RECEBIDO GABRIEL COURA BARCELOS,,220.0,0.0,4842.38,INTER,Receita com serviços,Outras,../data/raw/BANCO INTER-2023.xlsx
2023-01-27,PIX RECEBIDO GISELE MIYOKO ONUKI,,340.0,0.0,5182.38,INTER,Receita com serviços,Outras,../data/raw/BANCO INTER-2023.xlsx
2023-01-27,PIX ENVIADO NUCLEO DE INFORMACAO (REGISTRO DE DOMINIO),,0.0,76.0,5106.38,INTER,Despesas administrativas,Site/Hospedagem,../data/raw/BANCO INTER-2023.xlsx
2023-01-27,PIX ENVIADO LAURA AZEVEDO RODA - PAGTO RESCISÃO,,0.0,801.3,4305.08,INTER,Despesa com pessoal,Aviso prévio / Multa rescisória,../data/raw/BANCO INTER-2023.xlsx
2023-01-30,PIX RECEBIDO ALEXANDRE OENNING DE OLIVEIRA,,330.0,0.0,4635.08,INTER,Receita com serviços,Outras,../data/raw/BANCO INTER-2023.xlsx
2023-01-30,PIX RECEBIDO TALITA LOURENCO DOS SANTOS,,240.0,0.0,4875.08,INTER,Receita com serviços,Outras,../data/raw/BANCO INTER-2023.xlsx
2023-01-30,PIX RECEBIDO NATHALY BARBIERI TUCHTENHAGEN,,310.0,0.0,5185.08,INTER,Receita com serviços,Outras,../data/raw/BANCO INTER-2023.xlsx
2023-01-31,PIX ENVIADO MATHEUS - VT ESTAGIÁRIO,,0.0,209.0,4976.08,INTER,Despesa com pessoal,Transporte (VT),../data/raw/BANCO INTER-2023.xlsx
2023-02-01,PIX RECEBIDO JOZIEL DIAS DA SILVA,,180.0,0.0,5156.08,INTER,Receita com serviços,Outras,../data/raw/BANCO INTER-2023.xlsx
2023-02-01,PIX ENVIADO BARBARA VITTORIA RODRIGUES DE LIMA,,0.0,474.1,4681.98,INTER,Despesa com pessoal,Salário,../data/raw/BANCO INTER-2023.xlsx
2023-02-01,PIX ENVIADO GABRIEL PROENCA DOS SANTOS,,0.0,625.24,4056.74,INTER,Despesa com pessoal,Salário,../data/raw/BANCO INTER-2023.xlsx
2023-02-02,PIX RECEBIDO GABRIEL PASTI BATTESINI,,460.0,0.0,4516.74,INTER,Receita com serviços,Outras,../data/raw/BANCO INTER-2023.xlsx
2023-02-03,PIX ENVIADO SOELI APAR SOARES GONCALVES - PAGTO FRETE TERCEIRO (midea),,0.0,150.0,4366.74,INTER,Despesa com serviços,Transporte,../data/raw/BANCO INTER-2023.xlsx
2023-02-06,PIX ENVIADO TATYANA CHAVIER-PAGTO DE SALÁRIO,,0.0,1658.34,2708.4,INTER,Despesa com pessoal,Salário,../data/raw/BANCO INTER-2023.xlsx
2023-02-06,PIX ENVIADO THIAGO IANUCH MARIN-PAGTO DE SALÁRIO,,0.0,1422.37,1286.03,INTER,Despesa com pessoal,Salário,../data/raw/BANCO INTER-2023.xlsx
2023-02-06,PIX ENVIADO SILVIA -CONTABILIDADE HONORÁRIOS E DIRF,,0.0,801.0,485.03,INTER,Despesas administrativas,Contabilidade,../data/raw/BANCO INTER-2023.xlsx
2023-02-06,PIX RECEBIDO HELIO AUGUSTO CAMARGO DE ABREU,,960.0,0.0,1445.03,INTER,Receita com serviços,Outras,../data/raw/BANCO INTER-2023.xlsx
2023-02-07,PIX RCEBIDO DALMO COELHO BORGES,,35.0,0.0,1480.03,INTER,Receita com serviços,Outras,../data/raw/BANCO INTER-2023.xlsx
2023-02-07,PIX RECEBIDO IVONE DE JESUS SANTOS,,200.0,0.0,1680.03,INTER,Receita com serviços,Outras,../data/raw/BANCO INTER-2023.xlsx
2023-02-07,PIX RECEBIDO LAUDIMIR RODRIGUES JR,,200.0,0.0,1880.03,INTER,Receita com serviços,Outras,../data/raw/BANCO INTER-2023.xlsx
2023-02-07,PIX ENVIADO CLAUDIO - PAGTO PRO-LABORE,,0.0,1335.0,545.03,INTER,Despesa com pessoal,Pró labore,../data/raw/BANCO INTER-2023.xlsx
2023-02-08,PIX RECEBIDO JANAÍNA OLIVEIRA DA VEIGA,,16.0,0.0,561.03,INTER,Receita com serviços,Outras,../data/raw/BANCO INTER-2023.xlsx
2023-02-10,PIX RECEBIDO DALMO COELHO BORGES,,105.0,0.0,666.03,INTER,Receita com serviços,Outras,../data/raw/BANCO INTER-2023.xlsx
2023-02-10,PAGTO BOLETO WHITE MARTINS,,0.0,39.76,626.27,INTER,Despesa com produtos,Materiais de Consumo,../data/raw/BANCO INTER-2023.xlsx
2023-02-10,PIX RECEBIDO BRUNO FRAGOSO SALVADOR,,310.0,0.0,936.27,INTER,Receita com serviços,Outras,../data/raw/BANCO INTER-2023.xlsx
2023-02-10,PIX RECEBIDO ROSANE MARIA ALVES FAGUNDES,,440.0,0.0,1376.27,INTER,Receita com serviços,Outras,../data/raw/BANCO INTER-2023.xlsx
2023-02-13,COMPRA CARTÃO NO ESTABELECIMENTO IPM LTDA GUARATUBA,,0.0,8.9,1367.37,INTER,Outras Despesas ,Outras Despesas ,../data/raw/BANCO INTER-2023.xlsx
2023-02-13,PIX RECEBIDO ANTONIO BARBOSA,,160.0,0.0,1527.37,INTER,Receita com serviços,Outras,../data/raw/BANCO INTER-2023.xlsx
2023-02-14,PIX RECEBIDO FOX HOME CONSULTORIA IMOB LTDA,,2170.0,0.0,3697.37,INTER,Receita com serviços,Outras,../data/raw/BANCO INTER-2023.xlsx
2023-02-15,PIX RECEBIDO TADIANE ARABELE DE OLIVEIRA,,260.0,0.0,3957.37,INTER,Receita com serviços,Outras,../data/raw/BANCO INTER-2023.xlsx
2023-02-16,PIX RECEBIDO EDIFICIO QUEEN VICTORIA,,350.0,0.0,4307.37,INTER,Receita com serviços,Outras,../data/raw/BANCO INTER-2023.xlsx
2023-02-16,COMPRA CARTÃO NO ESTABELECIMENTO YUKI - COMBUSTÍVEL,,0.0,51.51,4255.86,INTER,Despesas administrativas,Combustivel,../data/raw/BANCO INTER-2023.xlsx
2023-02-16,COMPRA CARTÃO ZAMPROGNA,,0.0,28.0,4227.86,INTER,Outras Despesas ,Outras Despesas ,../data/raw/BANCO INTER-2023.xlsx
2023-02-16,PIX ENVIADO JACLEILSON JOSE MANTHAY - PAGTO RESCISÃO,,0.0,273.45,3954.41,INTER,Despesa com pessoal,Aviso prévio / Multa rescisória,../data/raw/BANCO INTER-2023.xlsx
2023-02-16,PIX ENVIADO OSIEL  - PAGTO DE COMBUSTÍVEL ECEEL,,0.0,285.0,3669.41,INTER,Despesas administrativas,Combustivel,../data/raw/BANCO INTER-2023.xlsx
2023-02-17,PIX RECEBIDO JOHANN ANDREAS WERNER,,180.0,0.0,3849.41,INTER,Receita com serviços,Outras,../data/raw/BANCO INTER-2023.xlsx
2023-02-17,PIX RECEBIDO PEDRO JOSE RIBEIRO DORNELLES,,340.0,0.0,4189.41,INTER,Receita com serviços,Outras,../data/raw/BANCO INTER-2023.xlsx
2023-02-22,PAGAMENTO FATURA CARTÃO INTER,,0.0,2573.36,1616.05,INTER,Outras Despesas ,Pgto fatura Cartão Credito,../data/raw/BANCO INTER-2023.xlsx
2023-02-24,COMPRA CARTÃO  PISTA 1 SAO JOSE,,0.0,4.7,1611.35,INTER,Outras Despesas ,Outras Despesas ,../data/raw/BANCO INTER-2023.xlsx
2023-02-24,COMPRA CARTÃO PISTA 2 SAO JOSE,,0.0,4.7,1606.65,INTER,Outras Despesas ,Outras Despesas ,../data/raw/BANCO INTER-2023.xlsx
2023-02-24,COMPRA CARTÃO ANACLAUDIADASILVA ITAPOA BR,,0.0,30.0,1576.65,INTER,Outras Despesas ,Outras Despesas ,../data/raw/BANCO INTER-2023.xlsx
2023-02-24,COMPRA CARTÃO IPM LTDA GUARATUBA,,0.0,8.9,1567.75,INTER,Outras Despesas ,Outras Despesas ,../data/raw/BANCO INTER-2023.xlsx
2023-02-27,PIX RECEBIDO GUILHERME SILVA NASCIMENTO,,540.0,0.0,2107.75,INTER,Receita com serviços,Outras,../data/raw/BANCO INTER-2023.xlsx
2023-02-27,CASHBACK CARTÃO DE CRÉDITO,,6.43,0.0,2114.18,INTER,Transferência (Crédito),Outras,../data/raw/BANCO INTER-2023.xlsx
2023-02-27,PIX ENVIADO CLAUDIO - REEMBOLSO DE DESPESAS EM SERVIÇOS,,0.0,802.0,1312.18,INTER,Despesa com pessoal,Transporte (VT),../data/raw/BANCO INTER-2023.xlsx
2023-02-28,PIX RECEBIDO EXCELÊNCIA ASSISTENCIA TECNICA ,,15.0,0.0,1327.18,INTER,Receita com serviços,Outras,../data/raw/BANCO INTER-2023.xlsx
2023-02-28,PIX RECEBIDO ALINE PATRICIA DE ASSIS,,80.0,0.0,1407.18,INTER,Receita com serviços,Outras,../data/raw/BANCO INTER-2023.xlsx
2023-03-01,PIX RECEBIDO LUIZ ALBERTO CAPELARI,,155.0,0.0,1562.18,INTER,Receita com serviços,Outras,../data/raw/BANCO INTER-2023.xlsx
2023-03-02,PIX RECEBIDO CARLA JANNUZZI,,120.0,0.0,1682.18,INTER,Receita com serviços,Outras,../data/raw/BANCO INTER-2023.xlsx
2023-03-02,PIX RECEBIDO WAGNER JOSE BRITO,,302.5,0.0,1984.68,INTER,Receita com serviços,Outras,../data/raw/BANCO INTER-2023.xlsx
2023-03-03,TED RECEBIDA - PAGSEGURO INTERNET LTDA,,1369.02,0.0,3353.7,INTER,Receita com serviços,Outras,../data/raw/BANCO INTER-2023.xlsx
2023-03-06,PIX RECEBIDO CONDOMINIO DOM RODRIGO FLAT SERVICE,,2667.0,0.0,6020.7,INTER,Receita com serviços,Outras,../data/raw/BANCO INTER-2023.xlsx
2023-03-06,PIX ENVIADO TATYANA CHAVIER - PAGTO DE SALÁRIO,,0.0,1683.5,4337.2,INTER,Despesa com pessoal,Salário,../data/raw/BANCO INTER-2023.xlsx
2023-03-06,PIX ENVIADO BARBARA V. R. DE LIMA - PAGTO DE SALÁRIO,,0.0,1368.43,2968.77,INTER,Despesa com pessoal,Salário,../data/raw/BANCO INTER-2023.xlsx
2023-03-06,TED RECEBIDA - PAGSEGURO INTERNET LTDA,,233.5,0.0,3202.27,INTER,Receita com serviços,Outras,../data/raw/BANCO INTER-2023.xlsx
2023-03-06,PIX ENVIADO GABRIEL PROENCA DOS SANTOS - PAGTO DE SALÁRIO,,0.0,1522.95,1679.32,INTER,Despesa com pessoal,Salário,../data/raw/BANCO INTER-2023.xlsx
2023-03-06,PIX ENVIADO ELISABETE - PAGTO PRO-LABORE,,0.0,1335.0,344.32,INTER,Despesa com pessoal,Pró labore,../data/raw/BANCO INTER-2023.xlsx
2023-03-06,PIX RECEBIDO VIP REMAPS LTDA,,370.0,0.0,714.32,INTER,Receita com serviços,Outras,../data/raw/BANCO INTER-2023.xlsx
2023-03-06,PIX RECEBIDO AROLDO GRESCHECHEN JUNIOR,,125.0,0.0,839.32,INTER,Receita com serviços,Outras,../data/raw/BANCO INTER-2023.xlsx
2023-03-07,PIX RECEBIDO ADIR VARCHAKI MARTINS,,180.0,0.0,1019.32,INTER,Receita com serviços,Outras,../data/raw/BANCO INTER-2023.xlsx
2023-03-08,PIX RECEBIDO RENATA ALVES VIEIRA,,260.0,0.0,1279.32,INTER,Receita com serviços,Outras,../data/raw/BANCO INTER-2023.xlsx
2023-03-08,PIX ENVIADO MATHEUS H. B. A. LEITE - VT ESTAGIÁRIO,,0.0,240.0,1039.32,INTER,Despesa com pessoal,Transporte (VT),../data/raw/BANCO INTER-2023.xlsx
2023-03-08,PIX RECEBIDO NORMA MONTE ALEGRE RIBEIRO,,65.0,0.0,104.32,INTER,Receita com serviços,Outras,../data/raw/BANCO INTER-2023.xlsx
2023-03-08,PIX ENVIADO BRENNO ALEXANDER - PAGTO TERCEIRO,,0.0,185.46,918.86,INTER,Despesa com pessoal,Salário,../data/raw/BANCO INTER-2023.xlsx
2023-03-08,PAGAMENTO URBS - VT BRUNNO E BIANCA,,0.0,446.94,471.92,INTER,Despesa com pessoal,Transporte (VT),../data/raw/BANCO INTER-2023.xlsx
2023-03-09,PIX ENVIADO PARA CRED CREA (ECEEL-TEC),,0.0,300.0,171.92,INTER,Transferência (Débito),Transferência / Reembolso,../data/raw/BANCO INTER-2023.xlsx
2023-03-13,PIX RECEBIDO CASSIANA GISLENE FARAGO,,90.0,0.0,261.92,INTER,Receita com serviços,Outras,../data/raw/BANCO INTER-2023.xlsx
2023-03-13,PIX RECEBIDO MAICON CLAITON DOS SANTOS FERREIRA,,40.0,0.0,301.92,INTER,Receita com serviços,Outras,../data/raw/BANCO INTER-2023.xlsx
2023-03-13,PIX RECEBIDO SERGIO CRUZ ARENHART,,350.0,0.0,651.92,INTER,Receita com serviços,Outras,../data/raw/BANCO INTER-2023.xlsx
2023-03-14,PIX RECEBIDO LUIS ANTONIO OLIVATO,,190.0,0.0,841.92,INTER,Receita com serviços,Outras,../data/raw/BANCO INTER-2023.xlsx
2023-03-14,PIX RECEBIDO RAQUEL PROSDOCIMO,,180.0,0.0,1021.92,INTER,Receita com serviços,Outras,../data/raw/BANCO INTER-2023.xlsx
2023-03-15,PIX RECEBIDO VITÓRIA DE SOUZA PALOMBO,,230.0,0.0,1251.92,INTER,Receita com serviços,Outras,../data/raw/BANCO INTER-2023.xlsx
2023-03-15,PIX RECEBIDO ANA CAROLINA DE SOUSA MATTOS,,227.0,0.0,1478.92,INTER,Receita com serviços,Outras,../data/raw/BANCO INTER-2023.xlsx
2023-03-15,PIX RECEBIDO FERNANDA KAWAGUCHI,,520.0,0.0,1998.92,INTER,Receita com serviços,Outras,../data/raw/BANCO INTER-2023.xlsx
2023-03-15,PIX RECEBIDO FERNANDA CRISTINA DO NASCIMENTO DE CA,,120.0,0.0,2118.92,INTER,Receita com serviços,Outras,../data/raw/BANCO INTER-2023.xlsx
2023-03-16,PIX RECEBIDO REFRIGERACAO AGUA VERDE LTDA,,280.0,0.0,2398.92,INTER,Receita com serviços,Outras,../data/raw/BANCO INTER-2023.xlsx
2023-03-16,PIX RECEBIDO SILVANA NEUMANN ALVES,,920.0,0.0,3318.92,INTER,Receita com serviços,Outras,../data/raw/BANCO INTER-2023.xlsx
2023-03-16,PIX RECEBIDO JOAO CLAUDIO ZANARDO,,260.0,0.0,3578.92,INTER,Receita com serviços,Outras,../data/raw/BANCO INTER-2023.xlsx
2023-03-16,PIX RECEBIDO ELIANA DE CASTRO DIAS,,280.0,0.0,3858.92,INTER,Receita com serviços,Outras,../data/raw/BANCO INTER-2023.xlsx
2023-03-16,PIX RECEBIDO RAFAEL DE CAMPOS BARBOSA,,275.0,0.0,4133.92,INTER,Receita com serviços,Outras,../data/raw/BANCO INTER-2023.xlsx
2023-03-17,PIX RECEBIDO PATRICIA DE SOUZA,,200.0,0.0,4333.92,INTER,Receita com serviços,Outras,../data/raw/BANCO INTER-2023.xlsx
2023-03-20,PIX RECEBIDO BENEDITA LINDAURA DA SILVA SANTOS DE,,200.0,0.0,4533.92,INTER,Receita com serviços,Outras,../data/raw/BANCO INTER-2023.xlsx
2023-03-20,PIX RECEBIDO R BORGERT EMPREENDIMENTOS IMOBILI,,360.0,0.0,4893.92,INTER,Receita com serviços,Outras,../data/raw/BANCO INTER-2023.xlsx
2023-03-21,PIX RECEBIDO SILVANA A S SIMON,,575.0,0.0,5468.92,INTER,Receita com serviços,Outras,../data/raw/BANCO INTER-2023.xlsx
2023-03-22,PIX RECEBIDO FERNANDA MARTINS,,200.0,0.0,5668.92,INTER,Receita com serviços,Outras,../data/raw/BANCO INTER-2023.xlsx
2023-03-22,CASHBACK CARTÃO DE CRÉDIRO,,8.38,0.0,5677.3,INTER,Transferência (Crédito),Outras,../data/raw/BANCO INTER-2023.xlsx
2023-03-23,TED ENVIADO WHITE MARTINS - PAGTO DE BOLETO REF. SETEMBRO/2022,,0.0,30.9,5646.4,INTER,Despesa com produtos,Materiais de Consumo,../data/raw/BANCO INTER-2023.xlsx
2023-03-23,PIX ENVIADO ETELVINA MARIA DE CASTRO TRINDADE - DEVOLUÇÃO REF. 26/01,,0.0,42.5,5603.9,INTER,Transferência (Débito),Transferência / Reembolso,../data/raw/BANCO INTER-2023.xlsx
2023-03-24,PIX RECEBIDO S R BAR E RESTAURANTE LTDA,,200.0,0.0,5803.9,INTER,Receita com serviços,Outras,../data/raw/BANCO INTER-2023.xlsx
2023-03-27,PIX RECEBIDO TELMA ANGELA DE ABREU OLIVEIRA,,120.0,0.0,5923.9,INTER,Receita com serviços,Outras,../data/raw/BANCO INTER-2023.xlsx
2023-03-27,TED RECEBIDA - PAGSEGURO INTERNET LTDA,,1617.66,0.0,7541.56,INTER,Receita com serviços,Outras,../data/raw/BANCO INTER-2023.xlsx
2023-03-27,PIX ENVIADO CLAUDIO - REEMBOLSO DE DESPESAS EM SERVIÇOS,,0.0,300.0,7241.56,INTER,Despesas administrativas,Outras,../data/raw/BANCO INTER-2023.xlsx
2023-03-29,PIX RECEBIDO TELMA ANGELA DE ABREU OLIVEIRA,,60.0,0.0,7301.56,INTER,Receita com serviços,Outras,../data/raw/BANCO INTER-2023.xlsx
2023-03-29,PIX RECEBIDO CLAUDIA OLEINIK,,67.75,0.0,7369.31,INTER,Receita com serviços,Outras,../data/raw/BANCO INTER-2023.xlsx
2023-03-30,PIX RECEBIDO SIMONE C CUBAS MACHADO,,170.0,0.0,7539.31,INTER,Receita com serviços,Outras,../data/raw/BANCO INTER-2023.xlsx
2023-03-31,PIX RECEBIDO TATYANA CHAVIER - VENDA DE PRODUTO,,707.0,0.0,8246.31,INTER,Receita com serviços,Outras,../data/raw/BANCO INTER-2023.xlsx
2023-03-31,PIX RECEBIDO COND. EDIF. CHÂTELET,,380.0,0.0,8626.31,INTER,Receita com serviços,Outras,../data/raw/BANCO INTER-2023.xlsx
2023-03-31,PIX RECEBIDO PAMPEIRO COMERCIO DE BATERIAS E ACE,,260.0,0.0,8886.31,INTER,Receita com serviços,Outras,../data/raw/BANCO INTER-2023.xlsx
2023-04-03,PIX RECEBIDO ROBSON FERNANDES,,475.22,0.0,9361.53,INTER,Receita com serviços,Outras,../data/raw/BANCO INTER-2023.xlsx
2023-04-03,PIX RECEBIDO FLAVIO LUIS FAVERO,,350.0,0.0,9711.53,INTER,Receita com serviços,Outras,../data/raw/BANCO INTER-2023.xlsx
2023-04-03,PIX RECEBIDO RONE MARCIO BARBOSA DAVID,,55.0,0.0,9766.53,INTER,Receita com serviços,Outras,../data/raw/BANCO INTER-2023.xlsx
2023-04-03,PIX RECEBIDO TITELMAN DIAS JUNIOR,,105.0,0.0,9871.53,INTER,Receita com serviços,Outras,../data/raw/BANCO INTER-2023.xlsx
2023-04-03,PIX RECEBIDO LUANA CRISTINA GAVIOLI,,40.0,0.0,9911.53,INTER,Receita com serviços,Outras,../data/raw/BANCO INTER-2023.xlsx
2023-04-03,PIX ENVIADO GUIA DE RECOLHIMENTO DO ESTADO DO PARANA,,0.0,1012.18,8899.35,INTER,Despesas tributárias ,Outras,../data/raw/BANCO INTER-2023.xlsx
2023-04-04,PIX RECEBIDO DIONE MEISTER RIBEIRO,,310.0,0.0,9209.35,INTER,Receita com serviços,Outras,../data/raw/BANCO INTER-2023.xlsx
2023-04-04,COMPRA CARTÃO NO ESTABELECIMENTO PISTA 1 SAO JOSE DOS BRA,,0.0,2.35,9207,INTER,Outras Despesas ,Outras Despesas ,../data/raw/BANCO INTER-2023.xlsx
2023-04-04,COMPRA CARTÃO NO ESTABELECIMENTO PISTA 1 SAO JOSE DOS BRA,,0.0,2.35,9204.65,INTER,Outras Despesas ,Outras Despesas ,../data/raw/BANCO INTER-2023.xlsx
2023-03-04,COMPRA CARTÃO NO ESTABELECIMENTO IPM LTDA GUARATUBA BRA,,0.0,4.5,9200.15,INTER,Outras Despesas ,Outras Despesas ,../data/raw/BANCO INTER-2023.xlsx
2023-03-04,COMPRA CARTÃO NO ESTABELECIMENTO SUPERMERCADOS BAVARESC PONTAL D,,0.0,18.49,9181.66,INTER,Despesa com pessoal,Alimentação (VR VA),../data/raw/BANCO INTER-2023.xlsx
2023-04-05,PIX RECEBIDO MARCIANE BIONDO,,300.0,0.0,9484.66,INTER,Receita com serviços,Outras,../data/raw/BANCO INTER-2023.xlsx
2023-04-05,PIX RECEBIDO CASSIANA GISLENE FARAGO,,90.0,0.0,9571.66,INTER,Receita com serviços,Outras,../data/raw/BANCO INTER-2023.xlsx
2023-04-05,PIX RECEBIDO BARBARA DE AVELAR FERRAZ PRINS,,240.0,0.0,9811.66,INTER,Receita com serviços,Outras,../data/raw/BANCO INTER-2023.xlsx
2023-04-06,PIX ENVIADO GABRIEL - PAGTO DE SALÁRIO,,0.0,1669.7,8141.96,INTER,Despesa com pessoal,Salário,../data/raw/BANCO INTER-2023.xlsx
2023-04-06,PIX ENVIADO TATYANA - PAGTO DE SALÁRIO,,0.0,1781.72,6360.24,INTER,Despesa com pessoal,Salário,../data/raw/BANCO INTER-2023.xlsx
2023-04-06,PIX ENVIADO BRENNO - PAGTO DE SALÁRIO,,0.0,677.22,5683.02,INTER,Despesa com pessoal,Salário,../data/raw/BANCO INTER-2023.xlsx
2023-04-06,PIX ENVIADO ELISABETE - PAGTO PRO-LABORE,,0.0,1335.0,4348.02,INTER,Despesa com pessoal,Pró labore,../data/raw/BANCO INTER-2023.xlsx
2023-04-06,PIX ENVIADO CLAUDIO - PAGTO PRO-LABORE,,0.0,1335.0,3013.02,INTER,Despesa com pessoal,Pró labore,../data/raw/BANCO INTER-2023.xlsx
2023-04-10,COMPRA CARTÃO VARGASMOTOPECAS CURITIBA,,0.0,60.9,2952.12,INTER,Despesas administrativas,Peças/acessórios veiculos,../data/raw/BANCO INTER-2023.xlsx
2023-04-10,PAGAMENTO - VR BENEFÍCIOS,,0.0,504.0,2448.12,INTER,Despesa com pessoal,Alimentação (VR VA),../data/raw/BANCO INTER-2023.xlsx
2023-04-10,PIX RECEBIDO JARINA DA COSTA SILVEIRA,,40.0,0.0,2488.12,INTER,Receita com serviços,Outras,../data/raw/BANCO INTER-2023.xlsx
2023-04-10,PIX RECEBIDO SILVANA A S SIMON,,575.0,0.0,3063.12,INTER,Receita com serviços,Outras,../data/raw/BANCO INTER-2023.xlsx
2023-04-10,PIX ENVIADO MATHEUS HENRIQUE - PAGTO TERCEIROS,,0.0,236.0,2827.12,INTER,Despesa com pessoal,Salário,../data/raw/BANCO INTER-2023.xlsx
2023-04-10,PIX RECEBIDO CARLA RODRIGUES PONTES,,180.0,0.0,3007.12,INTER,Receita com serviços,Outras,../data/raw/BANCO INTER-2023.xlsx
2023-04-11,PIX RECEBIDO FELIPE BERTOLDO BRANCO,,120.0,0.0,3127.12,INTER,Receita com serviços,Outras,../data/raw/BANCO INTER-2023.xlsx
2023-04-11,PIX RECEBIDO RODRIGO DE MORAES BARELLI,,120.0,0.0,3247.12,INTER,Receita com serviços,Outras,../data/raw/BANCO INTER-2023.xlsx
2023-04-12,PIX RECEBIDO DUARTECON CONTABILIDADE LTDA,,275.0,0.0,3522.12,INTER,Receita com serviços,Outras,../data/raw/BANCO INTER-2023.xlsx
2023-04-12,PIX RECEBIDO THAYS PEREIRA FERNANDES,,160.0,0.0,3682.12,INTER,Receita com serviços,Outras,../data/raw/BANCO INTER-2023.xlsx
2023-04-13,PIX RECEBIDO GABRIELA GROTH,,63.0,0.0,3745.12,INTER,Receita com serviços,Outras,../data/raw/BANCO INTER-2023.xlsx
2023-04-13,PIX RECEBIDO NATHALLE A M DESSARTRE,,57.5,0.0,3802.62,INTER,Receita com serviços,Outras,../data/raw/BANCO INTER-2023.xlsx
2023-04-13,PIX RECEBIDO CRISTINA PEREIRA VIECELI,,180.0,0.0,3982.62,INTER,Receita com serviços,Outras,../data/raw/BANCO INTER-2023.xlsx
2023-04-13,PIX RECEBIDO MARIANNA PORONIUK,,40.0,0.0,4022.62,INTER,Receita com serviços,Outras,../data/raw/BANCO INTER-2023.xlsx
2023-04-13,PIX RECEBIDO ELOYSE CAROLINE DAVET,,260.0,0.0,4282.62,INTER,Receita com serviços,Outras,../data/raw/BANCO INTER-2023.xlsx
2023-04-13,PIX RECEBIDO PAMELA PADILHA DA SILVA,,40.0,0.0,4322.62,INTER,Receita com serviços,Outras,../data/raw/BANCO INTER-2023.xlsx
2023-04-14,PIX RECEBIDO SIMONE BERNARDI SARTORI,,40.0,0.0,4362.62,INTER,Receita com serviços,Outras,../data/raw/BANCO INTER-2023.xlsx
2023-04-14,PIX RECEBIDO ELLYSA CARVALHO BUENO,,63.0,0.0,4425.62,INTER,Receita com serviços,Outras,../data/raw/BANCO INTER-2023.xlsx
2023-04-14,PIX RECEBIDO GILMARA MENDONCA LOPES,,220.0,0.0,4645.62,INTER,Receita com serviços,Outras,../data/raw/BANCO INTER-2023.xlsx
2023-04-14,PIX RECEBIDO VLM SERVICOS E EVENTOS LTDA,,220.0,0.0,4865.62,INTER,Receita com serviços,Outras,../data/raw/BANCO INTER-2023.xlsx
2023-04-14,PIX RECEBIDO CLAUDIA OLEINIK,,407.75,0.0,5273.37,INTER,Receita com serviços,Outras,../data/raw/BANCO INTER-2023.xlsx
2023-04-17,PIX RECEBIDO MAYARA MARCONI TEIXEIRA FERREIRA,,450.0,0.0,5723.37,INTER,Receita com serviços,Outras,../data/raw/BANCO INTER-2023.xlsx
2023-04-17,PIX RECEBIDO LAURA PAULINA MILITAO FOGACA,,200.0,0.0,5923.37,INTER,Receita com serviços,Outras,../data/raw/BANCO INTER-2023.xlsx
2023-04-18,PIX RECEBIDO RODRIGO VIDAL TORRES DE SOUSA,,270.0,0.0,6193.37,INTER,Receita com serviços,Outras,../data/raw/BANCO INTER-2023.xlsx
2023-04-18,PIX ENVIADO PROXYS C ELETRONICO LTDA,,0.0,69.6,6123.77,INTER,Outras Despesas ,Outras Despesas ,../data/raw/BANCO INTER-2023.xlsx
2023-04-18,PIX RECEBIDO FRANCISCO DAS CHAGAS LIRA BARRETO,,1000.0,0.0,7123.77,INTER,Receita com serviços,Outras,../data/raw/BANCO INTER-2023.xlsx
2023-04-19,PIX RECEBIDO SARALI MERENCIA KRUMEL,,380.0,0.0,7503.77,INTER,Receita com serviços,Outras,../data/raw/BANCO INTER-2023.xlsx
2023-04-19,PIX RECEBIDO GUSTAVO MAGNINO MACHADO,,110.0,0.0,7613.77,INTER,Receita com serviços,Outras,../data/raw/BANCO INTER-2023.xlsx
2023-04-20,PIX RECEBIDO ANDREA CRISTINA GRITI BUENO,,140.0,0.0,7753.77,INTER,Receita com serviços,Outras,../data/raw/BANCO INTER-2023.xlsx
2023-04-24,CASHBACK CARTÃO DE CRÉDITO,,7.68,0.0,7761.45,INTER,Transferência (Crédito),Outras,../data/raw/BANCO INTER-2023.xlsx
2023-04-24,PIX RECEBIDO FRANCINE SCHMITT,,350.0,0.0,8111.45,INTER,Receita com serviços,Outras,../data/raw/BANCO INTER-2023.xlsx
2023-04-24,TED ENVIADA WHITE MARTINS GASES INDUST,,0.0,30.9,8080.55,INTER,Despesa com produtos,Materiais de Consumo,../data/raw/BANCO INTER-2023.xlsx
2023-04-24,PIX ENVIADO EXPRESSO PRINCESA DOS CAMPOS S A,,0.0,10.0,5070.55,INTER,Despesa com pessoal,Transporte (VT),../data/raw/BANCO INTER-2023.xlsx
2023-04-24,PIX RECEBIDO MARGARIDA MARIA PAIVA MATOS DE SOUSA,,65.0,0.0,8135.55,INTER,Receita com serviços,Outras,../data/raw/BANCO INTER-2023.xlsx
2023-04-26,PIX RECEBIDO MIKAELLY SOARES FONSECA,,100.0,0.0,8235.55,INTER,Receita com serviços,Outras,../data/raw/BANCO INTER-2023.xlsx
2023-04-27,PIX RECEBIDO DANIELLE RODRIGUES DE CASTRO,,513.0,0.0,8748.55,INTER,Receita com serviços,Outras,../data/raw/BANCO INTER-2023.xlsx
2023-04-27,PIX RECEBIDO IVAN LUCAS REIS SILVA,,400.0,0.0,9148.55,INTER,Receita com serviços,Outras,../data/raw/BANCO INTER-2023.xlsx
2023-04-28,PIX RECEBIDO JESSICA FAVORETO SANTOS,,200.0,0.0,9348.55,INTER,Receita com serviços,Outras,../data/raw/BANCO INTER-2023.xlsx
2023-05-02,COMPRA CARTÃO - FERRY BOAT GUARATUBA,,0.0,4.5,9344.05,INTER,Despesas administrativas,Outras,../data/raw/BANCO INTER-2023.xlsx
2023-05-02,COMPRA CARTÃO -  FERRY BOAT GUARATUBA,,0.0,4.5,9339.55,INTER,Despesas administrativas,Outras,../data/raw/BANCO INTER-2023.xlsx
2023-05-03,PIX RECEBIDO ANDREA DE SOUSA CORDEIRO,,115.0,0.0,9454.55,INTER,Receita com serviços,Outras,../data/raw/BANCO INTER-2023.xlsx
2023-05-03,TED RECEBIDA - PAGSEGURO INTERNET LTDA,,1194.07,0.0,10648.62,INTER,Receita com serviços,Outras,../data/raw/BANCO INTER-2023.xlsx
2023-05-03,PAGTO GUIA RECOLHIMENTO DO ESTADO DO PARANÁ,,0.0,144.51,10504.11,INTER,Despesas tributárias ,Outras,../data/raw/BANCO INTER-2023.xlsx
2023-05-03,PAGTO GUIA RECOLHIMENTO DO ESTADO DO PARANÁ,,0.0,148.37,10355.74,INTER,Despesas tributárias ,Outras,../data/raw/BANCO INTER-2023.xlsx
2023-05-03,PIX RECEBIDO JUCIARA DA SILVA NASCIMENTO,,460.0,0.0,10815.74,INTER,Receita com serviços,Outras,../data/raw/BANCO INTER-2023.xlsx
2023-05-04,PIX RECEBIDO BRUNO CESAR VERONEZ,,260.0,0.0,11075.74,INTER,Receita com serviços,Outras,../data/raw/BANCO INTER-2023.xlsx
2023-03-04,PIX RECEBIDO HUDSON SILVA CEZAR,,65.0,0.0,11140.74,INTER,Receita com serviços,Outras,../data/raw/BANCO INTER-2023.xlsx
2023-05-05,PIX ENVIADO TATYANA CHAVIER,,0.0,1768.02,9372.72,INTER,Despesa com pessoal,Salário,../data/raw/BANCO INTER-2023.xlsx
2023-05-05,PIX ENVIADO GABRIEL PROENCA DOS SANTOS,,0.0,1594.54,7778.18,INTER,Despesa com pessoal,Salário,../data/raw/BANCO INTER-2023.xlsx
2023-05-05,PIX ENVIADO MATHEUS HENRIQUE BARBOZA ANTUNES LEIT,,0.0,385.64,7392.54,INTER,Despesa com pessoal,Salário,../data/raw/BANCO INTER-2023.xlsx
2023-05-05,PIX RECEBIDO BIANCA CRISTINA BONVINI,,120.0,0.0,7512.54,INTER,Receita com serviços,Outras,../data/raw/BANCO INTER-2023.xlsx
2023-05-05,PIX RECEBIDO ADRIANA JUFFERNBRUCH DE MOURA,,685.0,0.0,8197.54,INTER,Receita com serviços,Outras,../data/raw/BANCO INTER-2023.xlsx
2023-05-05,PIX RECEBIDO FABIO LUIZ HENZ,,160.0,0.0,8357.54,INTER,Receita com serviços,Outras,../data/raw/BANCO INTER-2023.xlsx
2023-05-08,COMPRA CARTÃO - BIG,,0.0,9.98,8347.56,INTER,Outras Despesas ,Outras Despesas ,../data/raw/BANCO INTER-2023.xlsx
2023-05-08,PIX RECEBIDO MATEUS NICODEMO OLIVEIRA,,120.0,0.0,8467.56,INTER,Receita com serviços,Outras,../data/raw/BANCO INTER-2023.xlsx
2023-05-08,PIX RECEBIDO JOAO VICTOR ALARCAO PEREIRA,,512.0,0.0,8979.56,INTER,Receita com serviços,Outras,../data/raw/BANCO INTER-2023.xlsx
2023-05-08,PAGTO CIEE - ESTAGIÁRIOS,,0.0,1316.76,7662.8,INTER,Despesa com pessoal,Salário,../data/raw/BANCO INTER-2023.xlsx
2023-05-08,PAGTO CIEE - ESTAGIÁRIO,,0.0,368.19,7294.61,INTER,Despesa com pessoal,Salário,../data/raw/BANCO INTER-2023.xlsx
2023-05-08,PIX RECEBIDO TATYANA CHAVIER - VENDA DE PRODUTO,,542.55,0.0,7837.16,INTER,Receita com serviços,Outras,../data/raw/BANCO INTER-2023.xlsx
2023-05-08,PIX RECEBIDO GORETI KURTZ,,210.0,0.0,8047.16,INTER,Receita com serviços,Outras,../data/raw/BANCO INTER-2023.xlsx
2023-05-08,PIX RECEBIDO FANY MEDINA DE OLIVEIRA,,220.0,0.0,8267.16,INTER,Receita com serviços,Outras,../data/raw/BANCO INTER-2023.xlsx
2023-05-09,PIX RECEBIDO TALITA TOCHETTO OLDERS,,450.0,0.0,8717.16,INTER,Receita com serviços,Outras,../data/raw/BANCO INTER-2023.xlsx
2023-05-09,PIX RECEBIDO MAURO RICARDO JACOBY,,530.0,0.0,9247.16,INTER,Receita com serviços,Outras,../data/raw/BANCO INTER-2023.xlsx
2023-05-09,PIX RECEBIDO ZULMIRA MACEDO FERREIRA,,100.0,0.0,9347.16,INTER,Receita com serviços,Outras,../data/raw/BANCO INTER-2023.xlsx
2023-05-09,PIX RECEBIDO TALITA TOCHETTO OLDERS,,25.0,0.0,9372.16,INTER,Receita com serviços,Outras,../data/raw/BANCO INTER-2023.xlsx
2023-05-09,PIX RECEBIDO CASSIO MUNHOZ ALVES,,240.0,0.0,9612.16,INTER,Receita com serviços,Outras,../data/raw/BANCO INTER-2023.xlsx
2023-05-09,PIX RECEBIDO EWERTON  UMAR GIMENEZ FRANCISCO,,260.0,0.0,9872.16,INTER,Receita com serviços,Outras,../data/raw/BANCO INTER-2023.xlsx
2023-05-10,PIX RECEBIDO ADRIANA C AMORIM,,220.0,0.0,10092.16,INTER,Receita com serviços,Outras,../data/raw/BANCO INTER-2023.xlsx
2023-05-10,PIX RECEBIDO TASSIANA GULIAS,,140.0,0.0,10232.16,INTER,Receita com serviços,Outras,../data/raw/BANCO INTER-2023.xlsx
2023-05-11,PIX RECEBIDO VINÍCIUS TAVARES DA ROCHA,,1105.0,0.0,11337.16,INTER,Receita com serviços,Outras,../data/raw/BANCO INTER-2023.xlsx
2023-05-11,PIX RECEBIDO DIEGO RICARDO KACHIMARECK ZIELINSKI,,200.0,0.0,11537.16,INTER,Receita com serviços,Outras,../data/raw/BANCO INTER-2023.xlsx
2023-05-11,PIX ENVIADO GOVERNO DO PARANA - IPVA MOTO-2023,,0.0,551.61,10985.55,INTER,Despesas tributárias ,IPVA,../data/raw/BANCO INTER-2023.xlsx
2023-05-11,PIX ENVIADO GOVERNO DO PARANA - IPVA SPIN-2023,,0.0,1843.6,9141.95,INTER,Despesas tributárias ,IPVA,../data/raw/BANCO INTER-2023.xlsx
2023-05-11,PIX ENVIADO BRENNO P/ ALIMENTAÇÃO HORA EXTRAS,,0.0,15.0,9126.95,INTER,Despesa com pessoal,Alimentação (VR VA),../data/raw/BANCO INTER-2023.xlsx
2023-05-11,PIX ENVIADO ROBSON P/ ALIMENTAÇÃO HORA EXTRAS,,0.0,15.0,9111.95,INTER,Despesa com pessoal,Alimentação (VR VA),../data/raw/BANCO INTER-2023.xlsx
2023-05-12,PIX RECEBIDO LUCIANA P B LOPES,,220.0,0.0,9331.95,INTER,Receita com serviços,Outras,../data/raw/BANCO INTER-2023.xlsx
2023-05-12,COMPRA CARTÃO - IPM GRARATUBA,,0.0,8.9,9323.05,INTER,Despesa com serviços,Transporte,../data/raw/BANCO INTER-2023.xlsx
2023-05-12,COMPRA CARTÃO - IPM GRARATUBA,,0.0,8.9,9314.15,INTER,Despesa com serviços,Transporte,../data/raw/BANCO INTER-2023.xlsx
2023-05-15,COMPRA CARTÃO - BIG,,0.0,84.54,9229.61,INTER,Outras Despesas ,Outras Despesas ,../data/raw/BANCO INTER-2023.xlsx
2023-05-15,PIX RECEBIDO LETICIA DE OLIVEIRA,,110.0,0.0,9339.61,INTER,Receita com serviços,Outras,../data/raw/BANCO INTER-2023.xlsx
2023-05-15,PIX RECEBIDO SANDRA MARA BATISTA DA FONSECA DE OLI,,340.0,0.0,9679.61,INTER,Receita com serviços,Outras,../data/raw/BANCO INTER-2023.xlsx
2023-05-15,PIX RECEBIDO FERNANDA ARANHA HAPNER,,395.0,0.0,10074.61,INTER,Receita com serviços,Outras,../data/raw/BANCO INTER-2023.xlsx
2023-05-15,PIX RECEBIDO RENATA HERCULINO LEITE,,40.0,0.0,10114.61,INTER,Receita com serviços,Outras,../data/raw/BANCO INTER-2023.xlsx
2023-05-15,PIX RECEBIDO ROSIANE ROCIO LIMA BLUM,,635.0,0.0,10749.61,INTER,Receita com serviços,Outras,../data/raw/BANCO INTER-2023.xlsx
2023-05-16,PIX RECEBIDO GORETI KURTZ,,200.0,0.0,10949.61,INTER,Receita com serviços,Outras,../data/raw/BANCO INTER-2023.xlsx
2023-05-16,PIX RECEBIDO BRUNA MONTANARI DUARTE NFC-e 1879,,100.0,0.0,11049.61,INTER,Receita com serviços,Outras,../data/raw/BANCO INTER-2023.xlsx
2023-05-16,PIX RECEBIDO JACKSON RODRIGUES DO NASCIMENTO NF-e 4273,,180.0,0.0,11229.61,INTER,Receita com serviços,Outras,../data/raw/BANCO INTER-2023.xlsx
2023-05-16,PIX RECEBIDO ERON BORTOLIN ZANIVAN,,580.0,0.0,11809.61,INTER,Receita com serviços,Outras,../data/raw/BANCO INTER-2023.xlsx
2023-05-16,PIX RECEBIDO SERGIO MARIANO SNAK,,200.0,0.0,12009.61,INTER,Receita com serviços,Outras,../data/raw/BANCO INTER-2023.xlsx
2023-05-17,PIX RECEBIDO CAROLINE SCHURHAUS,,390.0,0.0,12399.61,INTER,Receita com serviços,Outras,../data/raw/BANCO INTER-2023.xlsx
2023-05-17,PIX RECEBIDO ELETRO FAST,,135.0,0.0,12534.61,INTER,Receita com serviços,Outras,../data/raw/BANCO INTER-2023.xlsx
2023-05-17,PIX RECEBIDO FLAVIO DE CASTRO PEREIRA,,265.0,0.0,12799.61,INTER,Receita com serviços,Outras,../data/raw/BANCO INTER-2023.xlsx
2023-05-18,PIX RECEBIDO MARISTELA D GUANABENS,,580.0,0.0,13379.61,INTER,Receita com serviços,Outras,../data/raw/BANCO INTER-2023.xlsx
2023-05-18,PIX RECEBIDO TRJ GASTRONOMIA LTDA,,380.0,0.0,13759.61,INTER,Receita com serviços,Outras,../data/raw/BANCO INTER-2023.xlsx
2023-05-18,PIX RECEBIDO MARISTELA D GUANABENS,,20.0,0.0,13779.61,INTER,Receita com serviços,Outras,../data/raw/BANCO INTER-2023.xlsx
2023-05-18,PIX RECEBIDO JOZENILTON CARDOSO DA COSTA,,220.0,0.0,13999.61,INTER,Receita com serviços,Outras,../data/raw/BANCO INTER-2023.xlsx
2023-05-18,PIX RECEBIDO FAAL IND DE ESTOFADOS,,255.0,0.0,14254.61,INTER,Receita com serviços,Outras,../data/raw/BANCO INTER-2023.xlsx
2023-05-18,PIX RECEBIDO LUIZ ALBERTO CAPELARI,,260.0,0.0,14514.61,INTER,Receita com serviços,Outras,../data/raw/BANCO INTER-2023.xlsx
2023-05-18,PIX RECEBIDO ANTONIO PEPE,,180.0,0.0,14694.61,INTER,Receita com serviços,Outras,../data/raw/BANCO INTER-2023.xlsx
2023-05-18,PIX RECEBIDO ADRIANA DA LUZ,,100.0,0.0,14794.61,INTER,Receita com serviços,Outras,../data/raw/BANCO INTER-2023.xlsx
2023-05-18,PIX RECEBIDO VICTOR MACIEL SIMOES,,260.0,0.0,15054.61,INTER,Receita com serviços,Outras,../data/raw/BANCO INTER-2023.xlsx
2023-05-19,PIX ENVIADO BRENNO - ADIANTAMENTO SALÁRIO,,0.0,696.04,14358.57,INTER,Despesa com pessoal,Salário,../data/raw/BANCO INTER-2023.xlsx
2023-05-19,PAGAMENTO FATURA CARTÃO INTER,,0.0,3081.14,11277.43,INTER,Outras Despesas ,Pgto fatura Cartão Credito,../data/raw/BANCO INTER-2023.xlsx
2023-05-22,PIX RECEBIDO DEBORA WAGNER PINTO,,460.0,0.0,11737.43,INTER,Receita com serviços,Outras,../data/raw/BANCO INTER-2023.xlsx
2023-05-22,CASHBACK CARTÃO DE CRÉDITO,,7.7,0.0,11745.13,INTER,Transferência (Crédito),Outras,../data/raw/BANCO INTER-2023.xlsx
2023-05-23,PIX RECEBIDO JULIANA CARNEIRO DE ANDRADE,,300.0,0.0,12045.13,INTER,Receita com serviços,Outras,../data/raw/BANCO INTER-2023.xlsx
2023-05-23,PIX RECEBIDO CARINE CRISTIANE MACHADO URBIM PASA,,525.0,0.0,12570.13,INTER,Receita com serviços,Outras,../data/raw/BANCO INTER-2023.xlsx
2023-05-23,PIX RECEBIDO JOANA ANGELICA M RIBEIRO,,340.0,0.0,12910.13,INTER,Receita com serviços,Outras,../data/raw/BANCO INTER-2023.xlsx
2023-05-23,PIX RECEBIDO RAFHAELL STEFANNO NUNES,,80.0,0.0,12990.13,INTER,Receita com serviços,Outras,../data/raw/BANCO INTER-2023.xlsx
2023-05-24,PIX RECEBIDO HIRALDO WONSBECK,,123.5,0.0,13113.63,INTER,Receita com serviços,Outras,../data/raw/BANCO INTER-2023.xlsx
2023-05-24,PIX RECEBIDO LARISSA BACH,,40.0,0.0,13153.63,INTER,Receita com serviços,Outras,../data/raw/BANCO INTER-2023.xlsx
2023-05-25,PIX RECEBIDO DANIELLE RODRIGUES DE CASTRO,,130.0,0.0,13283.63,INTER,Receita com serviços,Outras,../data/raw/BANCO INTER-2023.xlsx
2023-05-25,PIX RECEBIDO SUELI MAZZER RENBERG,,610.0,0.0,13893.63,INTER,Receita com serviços,Outras,../data/raw/BANCO INTER-2023.xlsx
2023-05-25,PIX RECEBIDO SCHIRLEY A HENZEL MOCHI,,1325.0,0.0,15218.63,INTER,Receita com serviços,Outras,../data/raw/BANCO INTER-2023.xlsx
2023-05-26,COMPRA CARTÃO - IPM GRARATUBA,,0.0,8.9,15209.73,INTER,Despesa com serviços,Transporte,../data/raw/BANCO INTER-2023.xlsx
2023-05-29,COMPRA CARTÃO - IPM GRARATUBA,,0.0,8.9,15200.83,INTER,Despesa com serviços,Transporte,../data/raw/BANCO INTER-2023.xlsx
2023-05-29,COMPRA CARTÃO - RECARGA CELULAR DA EMPRESA,,0.0,10.0,15190.83,INTER,Despesas administrativas,"Telefonia (Celular, Fixo, Internet)",../data/raw/BANCO INTER-2023.xlsx
2023-05-29,PIX ENVIADO BRENNO - VALE,,0.0,50.0,15140.83,INTER,Despesa com pessoal,Transporte (VT),../data/raw/BANCO INTER-2023.xlsx
2023-05-30,PIX RECEBIDO VIVIANE PRELLE,,480.0,0.0,15620.83,INTER,Receita com serviços,Outras,../data/raw/BANCO INTER-2023.xlsx
2023-05-30,PIX RECEBIDO SIMONE APARECIDA FACINI,,160.0,0.0,15780.83,INTER,Receita com serviços,Outras,../data/raw/BANCO INTER-2023.xlsx
2023-05-30,PIX RECEBIDO SIMONE APARECIDA FACINI,,100.0,0.0,15880.83,INTER,Receita com serviços,Outras,../data/raw/BANCO INTER-2023.xlsx
2023-05-30,PIX RECEBIDO LUCINEIDE LABOISSIERE,,260.0,0.0,16140.83,INTER,Receita com serviços,Outras,../data/raw/BANCO INTER-2023.xlsx
2023-05-30,PIX RECEBIDO CONDOMINIO ED PETROPOLIS - NFS-e 2300,,2850.0,0.0,18990.83,INTER,Receita com serviços,Outras,../data/raw/BANCO INTER-2023.xlsx
2023-05-30,PIX ENVIADO BRENNO P/ ALIMENTAÇÃO HORA EXTRAS,,0.0,15.0,18975.83,INTER,Despesa com pessoal,Alimentação (VR VA),../data/raw/BANCO INTER-2023.xlsx
2023-05-31,PIX ENVIADO ROBSON  P/ ALIMENTAÇÃO HORA EXTRAS,,0.0,15.0,18960.83,INTER,Despesa com pessoal,Alimentação (VR VA),../data/raw/BANCO INTER-2023.xlsx
2023-05-31,PIX RECEBIDO LUCIMARA S PATRIAL,,380.0,0.0,19340.83,INTER,Receita com serviços,Outras,../data/raw/BANCO INTER-2023.xlsx
2023-05-31,PIX ENVIADO GUILHERME - VT ESTAGIÁRIO,,0.0,180.0,19160.83,INTER,Despesa com pessoal,Transporte (VT),../data/raw/BANCO INTER-2023.xlsx
2023-05-31,PIX ENVIADO MATHEUS - VT ESTAGIÁRIO,,0.0,240.0,18920.83,INTER,Despesa com pessoal,Transporte (VT),../data/raw/BANCO INTER-2023.xlsx
2023-05-31,PIX RECEBIDO GABRIELA ASSUITI,,340.0,0.0,19260.83,INTER,Receita com serviços,Outras,../data/raw/BANCO INTER-2023.xlsx
2023-06-01,PIX ENVIADO VR BENEF. SERV. PROC. AS,,0.0,980.0,18280.83,INTER,Despesa com pessoal,Alimentação (VR VA),../data/raw/BANCO INTER-2023.xlsx
2023-06-01,PIX RECEBIDO JULIANA SILVA MATEUS,,260.0,0.0,18540.83,INTER,Receita com serviços,Outras,../data/raw/BANCO INTER-2023.xlsx
2023-06-02,PIX RECEBIDO VIVIANE MAGALHAES DIAS,,260.0,0.0,18800.83,INTER,Receita com serviços,Outras,../data/raw/BANCO INTER-2023.xlsx
2023-06-02,PIX RECEBIDO VANESSA PINTO NOGUEIRA,,150.0,0.0,18950.83,INTER,Receita com serviços,Outras,../data/raw/BANCO INTER-2023.xlsx
2023-06-02,PIX ENVIADO BRENNO - VALE,,0.0,50.0,18900.83,INTER,Despesa com pessoal,Transporte (VT),../data/raw/BANCO INTER-2023.xlsx
2023-06-05,PIX RECEBIDO GORETI KURTZ - NF-e 4300,,430.0,0.0,19330.83,INTER,Receita com serviços,Outras,../data/raw/BANCO INTER-2023.xlsx
2023-06-05,PIX RECEBIDO VALDETE APARECIDA DA SILVA CAMARGO,,40.0,0.0,19370.83,INTER,Receita com serviços,Outras,../data/raw/BANCO INTER-2023.xlsx
2023-06-05,PIX RECEBIDO ALESSANDRO RODRIGUES SANTOS NFC-e 1892,,55.0,0.0,19425.83,INTER,Receita com serviços,Outras,../data/raw/BANCO INTER-2023.xlsx
2023-06-05,PIX ENVIADO GOVERNO DO PARANA SECRETARIA DE ESTAD - GRPR,,0.0,739.37,18686.46,INTER,Despesas tributárias ,Outras,../data/raw/BANCO INTER-2023.xlsx
2023-06-05,PIX RECEBIDO MAYRA MUNNO RODRIGUES,,80.0,0.0,18766.46,INTER,Receita com serviços,Outras,../data/raw/BANCO INTER-2023.xlsx
2023-06-05,PAGTO DE VT PARA CINTHYA,,0.0,242.94,18523.52,INTER,Despesa com pessoal,Transporte (VT),../data/raw/BANCO INTER-2023.xlsx
2023-06-05,PIX ENVIADO SANEPAR - PAGTO CONTA DE ÁGUA,,0.0,231.32,18292.2,INTER,Despesas administrativas,Água,../data/raw/BANCO INTER-2023.xlsx
2023-06-05,COMPRA CARTÃO - FERRY BOAT GUARATUBA,,0.0,4.5,18287.7,INTER,Despesas administrativas,Outras,../data/raw/BANCO INTER-2023.xlsx
2023-06-05,COMPRA CARTÃO - FERRY BOAT GUARATUBA,,0.0,4.5,18283.2,INTER,Despesas administrativas,Outras,../data/raw/BANCO INTER-2023.xlsx
2023-06-06,PIX RECEBIDO ABIGAIL LEITE COSTA,,195.0,0.0,18478.2,INTER,Receita com serviços,Outras,../data/raw/BANCO INTER-2023.xlsx
2023-06-06,COMPRA CARTÃO - VILA IZABEL MATERIAIS DE CONSTRUÇÃO,,0.0,29.75,18448.45,INTER,Despesas administrativas,Manutenção predial,../data/raw/BANCO INTER-2023.xlsx
2023-06-06,PIX ENVIADO TATYANA - PAGTO DE SALÁRIO,,0.0,1728.85,16719.6,INTER,Despesa com pessoal,Salário,../data/raw/BANCO INTER-2023.xlsx
2023-06-06,PIX ENVIADO GABRIEL - PAGTO DE SALÁRIO,,0.0,1561.93,15157.67,INTER,Despesa com pessoal,Salário,../data/raw/BANCO INTER-2023.xlsx
2023-06-06,PIX ENVIADO BRENNO - PAGTO DE SALÁRIO,,0.0,906.76,14250.91,INTER,Despesa com pessoal,Salário,../data/raw/BANCO INTER-2023.xlsx
2023-06-06,PIX ENVIADO THIAGO - PAGTO DE SALÁRIO,,0.0,1603.3,12647.61,INTER,Despesa com pessoal,Salário,../data/raw/BANCO INTER-2023.xlsx
2023-06-06,COMPRA CARTÃO MILIUM CURITIBA,,0.0,19.2,12628.41,INTER,Outras Despesas ,Outras Despesas ,../data/raw/BANCO INTER-2023.xlsx
2023-06-06,PIX ENVIADO ELISABETE - PAGTO PRO-LABORE,,0.0,1335.0,11293.41,INTER,Despesa com pessoal,Pró labore,../data/raw/BANCO INTER-2023.xlsx
2023-06-06,PIX ENVIADO CLAUDIO - PAGTO PRO-LABORE,,0.0,1335.0,9958.41,INTER,Despesa com pessoal,Pró labore,../data/raw/BANCO INTER-2023.xlsx
2023-06-06,PIX RECEBIDO BRUNO DE MENEZES PACOBAHYBA,,260.0,0.0,10218.41,INTER,Receita com serviços,Outras,../data/raw/BANCO INTER-2023.xlsx
2023-06-06,PIX RECEBIDO INNOVE T P LTDA - ME - NFS-e 2313,,600.0,0.0,10818.41,INTER,Receita com serviços,Outras,../data/raw/BANCO INTER-2023.xlsx
2023-06-06,PIX ENVIADO BRENNO P/ ALIMENTAÇÃO HORA EXTRAS,,0.0,15.0,10803.41,INTER,Despesa com pessoal,Alimentação (VR VA),../data/raw/BANCO INTER-2023.xlsx
2023-06-06,PIX ENVIADO ROBSON P/ ALIMENTAÇÃO HORA EXTRAS,,0.0,15.0,10788.41,INTER,Despesa com pessoal,Alimentação (VR VA),../data/raw/BANCO INTER-2023.xlsx
2023-06-07,PIX RECEBIDO RODRIGO F. DE FREITAS LOPES,,560.0,0.0,11348.41,INTER,Receita com serviços,Outras,../data/raw/BANCO INTER-2023.xlsx
2023-06-07,PAGTO DE BOLETO FRESNOMAQ-WAP,,0.0,160.9,11187.51,INTER,Despesa com produtos,Materiais de Consumo,../data/raw/BANCO INTER-2023.xlsx
2023-06-07,PIX ENVIADO DETRAN - LICENCIAMENTO ANUAL-2023,,0.0,90.94,11096.57,INTER,Despesas tributárias ,IPVA,../data/raw/BANCO INTER-2023.xlsx
2023-06-07,PIX ENVIADO DEPARTAMENTO DE TRANSITO DETRAN - MULTA,,0.0,104.13,10992.44,INTER,Despesas administrativas,Multas veiculos,../data/raw/BANCO INTER-2023.xlsx
2023-06-09,PIX RECEBIDO ADRIANO VERDERIO,,1624.5,0.0,12616.94,INTER,Receita com serviços,Outras,../data/raw/BANCO INTER-2023.xlsx
2023-06-09,PIX ENVIADO ROBSON - BONUS POR BOM SERVIÇO INSTALAÇÃO,,0.0,100.0,12516.94,INTER,Despesa com pessoal,Salário,../data/raw/BANCO INTER-2023.xlsx
2023-06-12,PIX RECEBIDO FERNANDA DA MATTA HASSELMANN,,1000.0,0.0,13516.94,INTER,Receita com serviços,Outras,../data/raw/BANCO INTER-2023.xlsx
2023-06-12,PIX ENVIADO WHITE MARTINS-PAGTO DIFERENÇA DE TED-NF 92101357,,0.0,8.86,13508.08,INTER,Despesa com produtos,Materiais de Consumo,../data/raw/BANCO INTER-2023.xlsx
2023-06-13,PIX RECEBIDO JAIR ANGELO,,260.0,0.0,13768.08,INTER,Receita com serviços,Outras,../data/raw/BANCO INTER-2023.xlsx
2023-06-14,PIX RECEBIDO CARMEN APARECIDA DE CARVALHO,,420.0,0.0,14188.08,INTER,Receita com serviços,Outras,../data/raw/BANCO INTER-2023.xlsx
2023-06-14,PIX RECEBIDO CRISTIANE APARECIDA SOARES DA FONSECA,,130.0,0.0,14318.08,INTER,Receita com serviços,Outras,../data/raw/BANCO INTER-2023.xlsx
2023-06-14,PIX RECEBIDO IRAN MATEUS REIS SILVA,,2300.0,0.0,16618.08,INTER,Receita com serviços,Outras,../data/raw/BANCO INTER-2023.xlsx
2023-06-14,PIX RECEBIDO MAYARA BIANCA DA COSTA SILVA 07771482,,580.0,0.0,17198.08,INTER,Receita com serviços,Outras,../data/raw/BANCO INTER-2023.xlsx
2023-06-14,PAGAMENTO CARTÃO AMERICAN,,0.0,1839.58,15358.5,INTER,Outras Despesas ,Pgto fatura Cartão Credito,../data/raw/BANCO INTER-2023.xlsx
2023-06-14,PAGAMENTO COPEL - ENERGIA LJ 3,,0.0,115.43,15243.07,INTER,Despesas administrativas,Energia,../data/raw/BANCO INTER-2023.xlsx
2023-06-14,PAGAMENTO COPEL - ENERGIA LJ 4,,0.0,46.94,15196.13,INTER,Despesas administrativas,Energia,../data/raw/BANCO INTER-2023.xlsx
2023-06-14,PAGAMENTO COPEL - ENERGIA LJ 6,,0.0,309.73,14886.4,INTER,Despesas administrativas,Energia,../data/raw/BANCO INTER-2023.xlsx
2023-06-15,PIX RECEBIDO JCS NEGOCIOS IMOBILIARIOS LTDA,,260.0,0.0,15146.4,INTER,Receita com serviços,Outras,../data/raw/BANCO INTER-2023.xlsx
2023-06-15,PIX RECEBIDO GISLAINE VERNIZE ALVES FERREIRA,,155.0,0.0,15301.4,INTER,Receita com serviços,Outras,../data/raw/BANCO INTER-2023.xlsx
2023-06-15,PIX ENVIADO BRENNO - PAGTO RESCISÃO DO CONTRATO,,0.0,1364.86,13936.54,INTER,Despesa com pessoal,Aviso prévio / Multa rescisória,../data/raw/BANCO INTER-2023.xlsx
2023-06-15,PIX ENVIADO ROBSON P/ ALIMENTAÇÃO HORA EXTRAS,,0.0,30.0,13906.54,INTER,Despesa com pessoal,Alimentação (VR VA),../data/raw/BANCO INTER-2023.xlsx
2023-06-16,PIX RECEBIDO TAISSA KAILAINE SOARES,,65.0,0.0,13971.54,INTER,Receita com serviços,Outras,../data/raw/BANCO INTER-2023.xlsx
2023-06-16,PIX RECEBIDO TANIA FREIRE C ARAUJO,,410.0,0.0,14381.54,INTER,Receita com serviços,Outras,../data/raw/BANCO INTER-2023.xlsx
2023-06-16,PIX RECEBIDO EVELISE JESUS C SERMANN,,350.0,0.0,14731.54,INTER,Receita com serviços,Outras,../data/raw/BANCO INTER-2023.xlsx
2023-06-19,PIX RECEBIDO BRUNO RAFAEL DA FONSECA,,220.0,0.0,14951.54,INTER,Receita com serviços,Outras,../data/raw/BANCO INTER-2023.xlsx
2023-06-19,COMPRA CARTÃO - GIRELLI COMERCIO,,0.0,48.85,14902.69,INTER,Outras Despesas ,Outras Despesas ,../data/raw/BANCO INTER-2023.xlsx
2023-06-19,PIX RECEBIDO PATRICIA S R RODRIGUES,,140.0,0.0,15042.69,INTER,Receita com serviços,Outras,../data/raw/BANCO INTER-2023.xlsx
2023-06-19,PIX RECEBIDO MARILDE LURDES FRANCA,,430.0,0.0,15472.69,INTER,Receita com serviços,Outras,../data/raw/BANCO INTER-2023.xlsx
2023-06-20,PIX RECEBIDO PERLA NASCIMENTO DA SILVA,,440.0,0.0,15912.69,INTER,Receita com serviços,Outras,../data/raw/BANCO INTER-2023.xlsx
2023-06-20,PIX RECEBIDO SANDRA RECH STUPP,,390.0,0.0,16302.69,INTER,Receita com serviços,Outras,../data/raw/BANCO INTER-2023.xlsx
2023-06-20,PIX RECEBIDO MARIANA LEAO MOREIRA,,490.0,0.0,16792.69,INTER,Receita com serviços,Outras,../data/raw/BANCO INTER-2023.xlsx
2023-06-20,PIX RECEBIDO MARIA LUIZA DIAS SILVEIRA,,120.0,0.0,16912.69,INTER,Receita com serviços,Outras,../data/raw/BANCO INTER-2023.xlsx
2023-06-20,PIX ENVIADO - PAGTO FATURA CARTÃO INTER,,0.0,3519.0,13393.69,INTER,Outras Despesas ,Pgto fatura Cartão Credito,../data/raw/BANCO INTER-2023.xlsx
2023-06-20,PIX RECEBIDO FERNANDO BARIDOTTI DOS SANTOS,,240.0,0.0,13633.69,INTER,Receita com serviços,Outras,../data/raw/BANCO INTER-2023.xlsx
2023-06-21,PIX RECEBIDO MAURELIANO FIUZA BARBOSA,,390.0,0.0,14023.69,INTER,Receita com serviços,Outras,../data/raw/BANCO INTER-2023.xlsx
2023-06-21,PIX RECEBIDO MARIA G S RIBEIRO,,330.0,0.0,14353.69,INTER,Receita com serviços,Outras,../data/raw/BANCO INTER-2023.xlsx
2023-06-21,PIX RECEBIDO ANDRE SHENG LAU CHIN,,120.0,0.0,14473.69,INTER,Receita com serviços,Outras,../data/raw/BANCO INTER-2023.xlsx
2023-06-22,PIX RECEBIDO MARTA REGINA BASSO RIZZI,,140.0,0.0,14613.69,INTER,Receita com serviços,Outras,../data/raw/BANCO INTER-2023.xlsx
2023-06-22,PIX RECEBIDO DANIEL PEIXOTO DURSKI,,240.0,0.0,14853.69,INTER,Receita com serviços,Outras,../data/raw/BANCO INTER-2023.xlsx
2023-06-23,PIX RECEBIDO CAIO LEONARDO CARVALHO OLIVEIRA,,240.0,0.0,15093.69,INTER,Receita com serviços,Outras,../data/raw/BANCO INTER-2023.xlsx
2023-06-23,PIX RECEBIDO SIRLENE MAZETO,,35.0,0.0,15128.69,INTER,Receita com serviços,Outras,../data/raw/BANCO INTER-2023.xlsx
2023-06-23,PIX ENVIADO ROBSON P/ ALIMENTAÇÃO HORA EXTRAS E BÔNUS,,0.0,100.0,15028.69,INTER,Despesa com pessoal,Alimentação (VR VA),../data/raw/BANCO INTER-2023.xlsx
2023-06-26,PIX ENVIADO CICERO GOMES CONSTRUTORA,,0.0,300.0,14728.69,INTER,Despesas administrativas,Manutenção predial,../data/raw/BANCO INTER-2023.xlsx
2023-06-26,TED RECEBIDA ABREE - ASSOCIACAO BRASILEIRA NF-e 4270,,664.24,0.0,15392.93,INTER,Receita com serviços,Outras,../data/raw/BANCO INTER-2023.xlsx
2023-06-26,PIX RECEBIDO ROBERTA LORUSSO ZANCHET,,405.0,0.0,15797.93,INTER,Receita com serviços,Outras,../data/raw/BANCO INTER-2023.xlsx
2023-06-26,PIX ENVIADO VR BENEF. SERV. PROC. SA,,0.0,150.0,15647.93,INTER,Despesa com pessoal,Alimentação (VR VA),../data/raw/BANCO INTER-2023.xlsx
2023-06-26,PIX ENVIADO CLAUDIO - PAGTO SERVIÇO PRESTADO AVULSO,,0.0,500.0,15147.93,INTER,Despesa com pessoal,Salário,../data/raw/BANCO INTER-2023.xlsx
2023-06-26,PIX RECEBIDO BRAULIO SANTOS,,1620.0,0.0,16767.93,INTER,Receita com serviços,Outras,../data/raw/BANCO INTER-2023.xlsx
2023-06-27,PIX RECEBIDO MIRIAM SAGRAMOR GIRARDI,,440.0,0.0,17207.93,INTER,Receita com serviços,Outras,../data/raw/BANCO INTER-2023.xlsx
2023-06-27,PIX RECEBIDO CLEBSON DA ROSA LIMA,,260.0,0.0,17467.93,INTER,Receita com serviços,Outras,../data/raw/BANCO INTER-2023.xlsx
2023-06-28,PIX RECEBIDO CAROLINA DE LIMA PINTO,,570.0,0.0,18037.93,INTER,Receita com serviços,Outras,../data/raw/BANCO INTER-2023.xlsx
2023-06-28,PIX RECEBIDO KEYLA MARQUES DE SOUZA,,380.0,0.0,18417.93,INTER,Receita com serviços,Outras,../data/raw/BANCO INTER-2023.xlsx
2023-06-28,PIX RECEBIDO JULIANA ABR SOARES ALMEIDA,,40.0,0.0,18457.93,INTER,Receita com serviços,Outras,../data/raw/BANCO INTER-2023.xlsx
2023-06-28,PIX RECEBIDO ERIK RADKE,,390.0,0.0,18847.93,INTER,Receita com serviços,Outras,../data/raw/BANCO INTER-2023.xlsx
2023-06-30,PIX RECEBIDO L SCHLANGER COMERCIO DE ARTIGOS EM GE,,220.0,0.0,19067.93,INTER,Receita com serviços,Outras,../data/raw/BANCO INTER-2023.xlsx
2023-06-30,PIX ENVIADO GUILHERME - VT ESTAGIÁRIO,,0.0,216.0,18851.93,INTER,Despesa com pessoal,Transporte (VT),../data/raw/BANCO INTER-2023.xlsx
2023-06-30,PIX ENVIADO MATHEUS - VT ESTAGIÁRIO,,0.0,252.0,18599.93,INTER,Despesa com pessoal,Transporte (VT),../data/raw/BANCO INTER-2023.xlsx
2023-06-30,PIX RECEBIDO WELLINGTON ZAMARA DE MONTE,,430.0,0.0,19029.93,INTER,Receita com serviços,Outras,../data/raw/BANCO INTER-2023.xlsx
2023-06-30,PIX RECEBIDO REGIANE C G MASCAMUDO,,220.0,0.0,19249.93,INTER,Receita com serviços,Outras,../data/raw/BANCO INTER-2023.xlsx
2023-07-03,COMPRA CARTÃO FS CURITIBA,,0.0,63.9,19186.03,INTER,Despesa com pessoal,Alimentação (VR VA),../data/raw/BANCO INTER-2023.xlsx
2023-07-03,PIX RECEBIDO MARIANA GELINSKI DA SILVA,,2300.0,0.0,21486.03,INTER,Receita com serviços,Outras,../data/raw/BANCO INTER-2023.xlsx
2023-07-03,PIX RECEBIDO RICARDO GARCIA,,420.0,0.0,21906.03,INTER,Receita com serviços,Outras,../data/raw/BANCO INTER-2023.xlsx
2023-07-03,PIX RECEBIDO RAQUEL DE CAMPOS,,440.0,0.0,22346.03,INTER,Receita com serviços,Outras,../data/raw/BANCO INTER-2023.xlsx
2023-07-03,PIX ENVIADO GOVERNO DO PARANA SECRETARIA DE ESTAD - GRPR,,0.0,1089.17,21256.86,INTER,Despesas tributárias ,Outras,../data/raw/BANCO INTER-2023.xlsx
2023-07-03,PAGTO SANEPAR - CONTA DE ÁGUA,,0.0,175.7,21081.16,INTER,Despesas administrativas,Água,../data/raw/BANCO INTER-2023.xlsx
2023-07-04,PIX RECEBIDO RATAZIMA,,220.0,0.0,21301.16,INTER,Receita com serviços,Outras,../data/raw/BANCO INTER-2023.xlsx
2023-07-05,PIX RECEBIDO MARCIO W L CAUPER,,540.0,0.0,21841.16,INTER,Receita com serviços,Outras,../data/raw/BANCO INTER-2023.xlsx
2023-07-05,PIX RECEBIDO MONKEY FOREST COM DE MAT ELET E HID R,,1000.0,0.0,22841.16,INTER,Receita com serviços,Outras,../data/raw/BANCO INTER-2023.xlsx
2023-07-06,PIX ENVIADO TATYANA CHAVIER - PAGTO DE SALÁRIO,,0.0,1727.5,21113.66,INTER,Despesa com pessoal,Salário,../data/raw/BANCO INTER-2023.xlsx
2023-07-06,PIX ENVIADO GABRIEL PROENCA DOS SANTOS - PAGTO DE SALÁRIO,,0.0,1487.98,19625.68,INTER,Despesa com pessoal,Salário,../data/raw/BANCO INTER-2023.xlsx
2023-07-06,PIX ENVIADO ELISABETE SEOLIN GALINDO - PAGTO PRO-LABORE,,0.0,1335.0,18290.68,INTER,Despesa com pessoal,Pró labore,../data/raw/BANCO INTER-2023.xlsx
2023-07-06,PIX ENVIADO CLAUDIO VINICIUS GALINDO - PAGTO PRO-LABORE,,0.0,1335.0,16955.68,INTER,Despesa com pessoal,Pró labore,../data/raw/BANCO INTER-2023.xlsx
2023-07-06,PIX RECEBIDO PATRICIA CORDEIRO,,220.0,0.0,17175.68,INTER,Receita com serviços,Outras,../data/raw/BANCO INTER-2023.xlsx
2023-07-06,COMPRA CARTÃO MERCADO ZAMPROGNA,,0.0,45.93,17129.75,INTER,Despesa com pessoal,Alimentação (VR VA),../data/raw/BANCO INTER-2023.xlsx
2023-07-06,TRANSFERÊNCIA A CREDITO SHAULYN NASCIMENTO,,400.0,0.0,17529.75,INTER,Receita com serviços,Outras,../data/raw/BANCO INTER-2023.xlsx
2023-07-07,PIX RECEBIDO ALYNE GIAQUINTO CORREIA KAWAMURA,,160.0,0.0,17689.75,INTER,Receita com serviços,Outras,../data/raw/BANCO INTER-2023.xlsx
2023-07-07,PIX RECEBIDO MARIA DO ROCIO NUNES DE SOUZA,,340.0,0.0,18029.75,INTER,Receita com serviços,Outras,../data/raw/BANCO INTER-2023.xlsx
2023-07-07,PIX RECEBIDO MARIA DE LOURDES VITORIANO,,345.0,0.0,18374.75,INTER,Receita com serviços,Outras,../data/raw/BANCO INTER-2023.xlsx
2023-07-07,PIX RECEBIDO LUCAS STOLF,,260.0,0.0,18634.75,INTER,Receita com serviços,Outras,../data/raw/BANCO INTER-2023.xlsx
2023-07-10,PIX RECEBIDO JOSE PAIM BRITES NETO,,400.0,0.0,19034.75,INTER,Receita com serviços,Outras,../data/raw/BANCO INTER-2023.xlsx
2023-07-10,PIX RECEBIDO JOSE BELARMINO ROSA,,170.0,0.0,19204.75,INTER,Receita com serviços,Outras,../data/raw/BANCO INTER-2023.xlsx
2023-07-11,PIX RECEBIDO ALINE MENDES,,40.0,0.0,19244.75,INTER,Receita com serviços,Outras,../data/raw/BANCO INTER-2023.xlsx
2023-07-11,PIX RECEBIDO RENATO CAPOBIANGO,,460.0,0.0,19704.75,INTER,Receita com serviços,Outras,../data/raw/BANCO INTER-2023.xlsx
2023-07-12,PIX RECEBIDO MONICA SILVA A FERREIRA,,390.0,0.0,20094.75,INTER,Receita com serviços,Outras,../data/raw/BANCO INTER-2023.xlsx
2023-07-12,PIX RECEBIDO GUILHERME HEPP PERSONAL,,70.0,0.0,20164.75,INTER,Receita com serviços,Outras,../data/raw/BANCO INTER-2023.xlsx
2023-07-13,PIX RECEBIDO DOUGLAS EDUARDO GUERREIRO DE OLIVEIRA,,90.0,0.0,20254.75,INTER,Receita com serviços,Outras,../data/raw/BANCO INTER-2023.xlsx
2023-07-13,PIX RECEBIDO JORGE LUIS SILVA DO CANTO,,65.0,0.0,20319.75,INTER,Receita com serviços,Outras,../data/raw/BANCO INTER-2023.xlsx
2023-07-13,PIX RECEBIDO CARLOS ZARDIN GRAEFF,,400.0,0.0,20719.75,INTER,Receita com serviços,Outras,../data/raw/BANCO INTER-2023.xlsx
2023-07-14,PIX RECEBIDO IRMAOS A OBRA SERVICOS ESPECIALIZ,,35.0,0.0,20754.75,INTER,Receita com serviços,Outras,../data/raw/BANCO INTER-2023.xlsx
2023-07-14,PIX ENVIADO TATYANA CHAVIER - PAGTO DE FÉRIAS,,0.0,1469.8,19284.95,INTER,Despesa com pessoal,Salário,../data/raw/BANCO INTER-2023.xlsx
2023-07-14,PAGAM. COPEL - ENERGIA LJ 4,,0.0,52.54,19232.41,INTER,Despesas administrativas,Energia,../data/raw/BANCO INTER-2023.xlsx
2023-07-14,PAGAM. COPEL - ENERGIA LJ 6,,0.0,409.24,18823.17,INTER,Despesas administrativas,Energia,../data/raw/BANCO INTER-2023.xlsx
2023-07-14,PAGAM. COPEL - ENERGIA LJ 3,,0.0,126.57,18696.6,INTER,Despesas administrativas,Energia,../data/raw/BANCO INTER-2023.xlsx
2023-07-17,PIX ENVIADO - TAISE BOFF ANGELI,,0.0,200.0,18496.6,INTER,Outras Despesas ,Outras Despesas ,../data/raw/BANCO INTER-2023.xlsx
2023-07-17,PIX RECEBIDO MARCOS RODRIGO BECKER DA SILVA,,185.0,0.0,18681.6,INTER,Receita com serviços,Outras,../data/raw/BANCO INTER-2023.xlsx
2023-07-18,PAGAMENTO BOLETO PACKPAR,,0.0,196.56,18485.04,INTER,Despesa com produtos,Materiais de Consumo,../data/raw/BANCO INTER-2023.xlsx
2023-07-18,PAGAMENTO BOLETO SPRINGER CARRIER,,0.0,712.29,17772.75,INTER,Outras Despesas ,Outras Despesas ,../data/raw/BANCO INTER-2023.xlsx
2023-07-18,PIX ENVIADO VIBRA ENERGIA AS - COMBUSTÍVEL,,0.0,181.75,17591,INTER,Despesas administrativas,Combustivel,../data/raw/BANCO INTER-2023.xlsx
2023-07-18,COMPRA CARTÃO IPM LTDA GUARATUBA - FERRY BOAT,,0.0,8.9,17582.1,INTER,Despesas administrativas,Outras,../data/raw/BANCO INTER-2023.xlsx
2023-07-18,COMPRA CARTÃO IPM LTDA GUARATUBA - FERRY BOAT,,0.0,8.9,17573.2,INTER,Despesas administrativas,Outras,../data/raw/BANCO INTER-2023.xlsx
2023-07-19,PIX RECEBIDO TAIS REGINA WEBER,,440.0,0.0,18013.2,INTER,Receita com serviços,Outras,../data/raw/BANCO INTER-2023.xlsx
2023-07-19,PIX RECEBIDO ALESSANDRO RIBEIRO LIMA,,40.0,0.0,18053.2,INTER,Receita com serviços,Outras,../data/raw/BANCO INTER-2023.xlsx
2023-07-19,PIX RECEBIDO PAULO EDUARDO DE ANDRADE BALTAR,,240.0,0.0,18293.2,INTER,Receita com serviços,Outras,../data/raw/BANCO INTER-2023.xlsx
2023-07-19,PAGTO CARTÃO INTER,,0.0,2695.34,15597.86,INTER,Outras Despesas ,Pgto fatura Cartão Credito,../data/raw/BANCO INTER-2023.xlsx
2023-07-19,PAGTO EMBALATEC IND EMBALAGENS,,0.0,1114.6,14483.26,INTER,Despesa com produtos,Materiais de Consumo,../data/raw/BANCO INTER-2023.xlsx
2023-07-20,PIX RECEBIDO MARILIA CLAUDIA OLIVEIRA PAES DE LIMA,,480.0,0.0,14963.26,INTER,Receita com serviços,Outras,../data/raw/BANCO INTER-2023.xlsx
2023-07-20,PIX RECEBIDO CLAUDIA FARIA BRINCK,,580.0,0.0,15543.26,INTER,Receita com serviços,Outras,../data/raw/BANCO INTER-2023.xlsx
2023-07-20,PIX RECEBIDO  EVANDRO HENRIQUE HARENZA,,395.0,0.0,15938.26,INTER,Receita com serviços,Outras,../data/raw/BANCO INTER-2023.xlsx
2023-07-21,PIX ENVIADO VIBRA ENERGIA AS,,0.0,40.0,15898.26,INTER,Despesas administrativas,Energia,../data/raw/BANCO INTER-2023.xlsx
2023-07-21,PIX RECEBIDO MARIA DE LOURDES VITORIANO,,545.0,0.0,16443.26,INTER,Receita com serviços,Outras,../data/raw/BANCO INTER-2023.xlsx
2023-07-24,PIX RECEBIDO FABRIZIA BORGES GUIMARAES,,240.0,0.0,16683.26,INTER,Receita com serviços,Outras,../data/raw/BANCO INTER-2023.xlsx
2023-07-24,PIX RECEBIDO PEDRO DA SILVA PINTO,,40.0,0.0,16723.26,INTER,Receita com serviços,Outras,../data/raw/BANCO INTER-2023.xlsx
2023-07-24,PIX ENVIADO EDRIC PAGTO AT. PANASONIC,,0.0,35.0,16688.26,INTER,Despesa com serviços,Mão de obra,../data/raw/BANCO INTER-2023.xlsx
2023-07-24,COMPRA CARTÃO - CARREFOUR,,0.0,59.98,16628.28,INTER,Outras Despesas ,Outras Despesas ,../data/raw/BANCO INTER-2023.xlsx
2023-07-24,PIX ENVIADO NUCLEO DE INFORMACAO E COORDENACAO DO,,0.0,76.0,16552.28,INTER,Outras Despesas ,Outras Despesas ,../data/raw/BANCO INTER-2023.xlsx
2023-07-25,PIX RECEBIDO TATYANA FERNANDES RODRIGUES,,40.0,0.0,16592.28,INTER,Receita com serviços,Outras,../data/raw/BANCO INTER-2023.xlsx
2023-07-25,PIX ENVIADO MAGAZINE LUIZA MARKETPLACE,,0.0,465.67,16126.61,INTER,Outras Despesas ,Outras Despesas ,../data/raw/BANCO INTER-2023.xlsx
2023-07-25,PIX RECEBIDO WERICA NELI DE CASTRO PAVIN,,730.0,0.0,16856.61,INTER,Receita com serviços,Outras,../data/raw/BANCO INTER-2023.xlsx
2023-07-27,PIX RECEBIDO ENPROL ENGENHARIA E PROJETOS LTD,,380.0,0.0,17236.61,INTER,Receita com serviços,Outras,../data/raw/BANCO INTER-2023.xlsx
2023-07-27,PIX ENVIADO ROBSON P/ ALIMENTAÇÃO HORA EXTRAS,,0.0,45.0,17191.61,INTER,Despesa com pessoal,Alimentação (VR VA),../data/raw/BANCO INTER-2023.xlsx
2023-07-28,PIX RECEBIDO MONTEMOR INVESTIMENTOS E PARTICIPACOE - NFS-e 2343,,1400.0,0.0,18591.61,INTER,Receita com serviços,Outras,../data/raw/BANCO INTER-2023.xlsx
2023-07-28,PIX RECEBIDO CAROLINA GASPARINI BARBOSA HELLER,,340.0,0.0,18931.61,INTER,Receita com serviços,Outras,../data/raw/BANCO INTER-2023.xlsx
2023-07-28,PIX RECEBIDO VIVIANNE CARVALHO DA CUNHA TRAJANO,,180.0,0.0,19111.61,INTER,Receita com serviços,Outras,../data/raw/BANCO INTER-2023.xlsx
2023-07-28,PIX RECEBIDO TAMARYS DANIELLA CAILLET DE OLIVEIRA,,435.0,0.0,19546.61,INTER,Receita com serviços,Outras,../data/raw/BANCO INTER-2023.xlsx
2023-07-31,COMPRA CARTÃO - SUPER PRO,,0.0,25.49,19521.12,INTER,Outras Despesas ,Outras Despesas ,../data/raw/BANCO INTER-2023.xlsx
2023-07-31,PIX ENVIADO DETRAN - LICENCIAMENTO ANUAL-2023 MOTO,,0.0,90.94,19430.18,INTER,Despesas tributárias ,IPVA,../data/raw/BANCO INTER-2023.xlsx
2023-07-31,PIX ENVIADO DEPARTAMENTO DE TRANSITO DETRAN - MULTA SPIN,,0.0,394.36,19035.82,INTER,Despesas administrativas,Multas veiculos,../data/raw/BANCO INTER-2023.xlsx
2023-07-31,PIX ENVIADO MATHEUS LAURENTINO DA ROSA - VT ESTAGIÁRIO,,0.0,276.0,18759.82,INTER,Despesa com pessoal,Transporte (VT),../data/raw/BANCO INTER-2023.xlsx
2023-07-31,PIX ENVIADO MATHEUS LAURENTINO DA ROSA - SERVIÇO PRESTADO,,0.0,120.0,18639.82,INTER,Despesa com pessoal,Salário,../data/raw/BANCO INTER-2023.xlsx
2023-07-31,PAGAMENTO BOLETO - VR BENEFÍCIOS,,0.0,1100.0,17539.82,INTER,Despesa com pessoal,Alimentação (VR VA),../data/raw/BANCO INTER-2023.xlsx
2023-07-31,PIX RECEBIDO PAMELA SABRINNE DOS SANTOS PEREIRA,,220.0,0.0,17759.82,INTER,Receita com serviços,Outras,../data/raw/BANCO INTER-2023.xlsx
2023-08-01,PIX RECEBIDO FRANK,,389.0,0.0,18148.82,INTER,Receita com serviços,Outras,../data/raw/BANCO INTER-2023.xlsx
2023-08-01,COMPRA CARTÃO PANIFICADORA COLONIAL PONTA GROSSA - AT. MIDEA,,0.0,64.8,18084.02,INTER,Despesa com pessoal,Alimentação (VR VA),../data/raw/BANCO INTER-2023.xlsx
2023-08-02,PIX RECEBIDO JANAINA RIGO VICENZI,,470.0,0.0,18554.02,INTER,Receita com serviços,Outras,../data/raw/BANCO INTER-2023.xlsx
2023-08-02,PAGTO SELETROAR - PARCELA 2 DE 5,,0.0,92.79,18461.23,INTER,Outras Despesas ,Outras Despesas ,../data/raw/BANCO INTER-2023.xlsx
2023-08-02,PIX ENVIADO GOVERNO DO PARANA SECRETARIA DE ESTAD - GRPR,,0.0,66.35,18394.88,INTER,Despesas tributárias ,Outras,../data/raw/BANCO INTER-2023.xlsx
2023-08-02,PAGTO SANEPAR - CONTA DE ÁGUA,,0.0,204.88,18190,INTER,Despesas administrativas,Água,../data/raw/BANCO INTER-2023.xlsx
2023-08-03,PIX ENVIADO LUIZ GUILHERME - AUXÍLIO COMBUSTÍVEL,,0.0,200.0,17990,INTER,Despesas administrativas,Combustivel,../data/raw/BANCO INTER-2023.xlsx
2023-08-04,PIX ENVIADO TATYANA CHAVIER - PAGTO DE SALÁRIO,,0.0,937.1,17052.9,INTER,Despesa com pessoal,Salário,../data/raw/BANCO INTER-2023.xlsx
2023-08-04,PIX ENVIADO CLAUDIO VINICIUS GALINDO - PAGTO PRO-LABORE,,0.0,1335.0,15717.9,INTER,Despesa com pessoal,Pró labore,../data/raw/BANCO INTER-2023.xlsx
2023-08-04,PIX ENVIADO SILVIA CRISTINA ARRUDA - PAGTO HONORÁRIOS CONTABILIDADE,,0.0,523.0,15194.9,INTER,Despesas administrativas,Contabilidade,../data/raw/BANCO INTER-2023.xlsx
2023-08-04,PIX ENVIADO GABRIEL SANTOS - PAGTO QUITAÇÃO DE RESCISÃO DE TRABALHO,,0.0,5662.6,9532.3,INTER,Despesa com pessoal,Aviso prévio / Multa rescisória,../data/raw/BANCO INTER-2023.xlsx
2023-08-07,PIX RECEBIDO IDALMA BORGES GREIN,,40.0,0.0,9572.3,INTER,Receita com serviços,Outras,../data/raw/BANCO INTER-2023.xlsx
2023-08-07,COMPRA CARTÁO NO ESTABELECIMENTO IPM LTDA GUARATUBA -FERRY BOAT,,0.0,8.9,9563.4,INTER,Despesas administrativas,Outras,../data/raw/BANCO INTER-2023.xlsx
2023-08-07,COMPRA CARTÃO - SUBWAY - LANCHE ATEND ON-SITE GUARATUBA,,0.0,35.0,9528.4,INTER,Despesa com pessoal,Alimentação (VR VA),../data/raw/BANCO INTER-2023.xlsx
2023-08-07,COMPRA CARTÃO NO ESTABELECIMENTO IPM LTDA GUARATUBA -FERRY BOAT,,0.0,8.9,9519.5,INTER,Despesas administrativas,Outras,../data/raw/BANCO INTER-2023.xlsx
2023-08-07,COMPRA CARTÃO - LANCHE AT. ON-SITE MATINHOS,,0.0,39.8,9479.7,INTER,Despesa com pessoal,Alimentação (VR VA),../data/raw/BANCO INTER-2023.xlsx
2023-08-07,PIX RECEBIDO FABIANO DA PIEVE SCHERER,,350.0,0.0,9829.7,INTER,Receita com serviços,Outras,../data/raw/BANCO INTER-2023.xlsx
2023-08-07,PIX ENVIADO LARYSSA - PAGTO DE SERVIÇOS PRESTADOS DE TERCEIROS,,0.0,1350.0,8479.7,INTER,Despesa com pessoal,Salário,../data/raw/BANCO INTER-2023.xlsx
2023-08-08,PIX RECEBIDO SIMONE PRESTES DOS SANTOS,,385.0,0.0,8864.7,INTER,Receita com serviços,Outras,../data/raw/BANCO INTER-2023.xlsx
2023-08-15,PIX RECEBIDO CAMILA MAKINO REZENDE MONTEMEZZO,,20.0,0.0,8884.7,INTER,Receita com serviços,Outras,../data/raw/BANCO INTER-2023.xlsx
2023-08-15,PIX ENVIADO ROBSON -PAGTO DE ESTAR E ALIMENTAÇÃO HORA EXTRAS,,0.0,45.0,8839.7,INTER,Despesa com pessoal,Salário,../data/raw/BANCO INTER-2023.xlsx
2023-08-16,PIX RECEBIDO LANTERI MARKETING CULTURAL LTDA - ME,,40.0,0.0,8879.7,INTER,Receita com serviços,Outras,../data/raw/BANCO INTER-2023.xlsx
2023-08-17,PIX RECEBIDO RICARDO LIBERAL DA SILVA,,260.0,0.0,9139.7,INTER,Receita com serviços,Outras,../data/raw/BANCO INTER-2023.xlsx
2023-08-17,PIX RECEBIDO RODRIGO CANDIDO FERREIRA,,470.0,0.0,9609.7,INTER,Receita com serviços,Outras,../data/raw/BANCO INTER-2023.xlsx
2023-08-18,PIX ENVIADO LUIZ GUILHERME KRAUSE - ADIANTAMENTO SALÁRIO,,0.0,800.0,8809.7,INTER,Despesa com pessoal,Salário,../data/raw/BANCO INTER-2023.xlsx
2023-08-18,PIX ENVIADO BRENDA RIBEIRO DE MELLO - ADIANTAMENTO SALÁRIO,,0.0,561.32,8248.38,INTER,Despesa com pessoal,Salário,../data/raw/BANCO INTER-2023.xlsx
2023-08-18,PIX ENVIADO PAGTO CARTÃO INTER,,0.0,3570.11,4678.27,INTER,Outras Despesas ,Pgto fatura Cartão Credito,../data/raw/BANCO INTER-2023.xlsx
2023-08-18,OIX RECEBIDO BIANCA SCHASTAI,,260.0,0.0,4938.27,INTER,Receita com serviços,Outras,../data/raw/BANCO INTER-2023.xlsx
2023-08-21,PIX RECEBIDO INUSITTA AMBIENTES PLANEJADOS LTDA,,890.0,0.0,5828.27,INTER,Receita com serviços,Outras,../data/raw/BANCO INTER-2023.xlsx
2023-08-21,PIX RECEBIDO FRESNOMAQ IND. DE MÁQ. (WAP) NFS-e 2345,,3955.0,0.0,9783.27,INTER,Receita com serviços,Outras,../data/raw/BANCO INTER-2023.xlsx
2023-08-21,PIX RECEBIDO JONAS FERNANDES,,400.0,0.0,10183.27,INTER,Receita com serviços,Outras,../data/raw/BANCO INTER-2023.xlsx
2023-08-21,PIX RECEBIDO FRANCISCO IGLESIAS,,430.0,0.0,10613.27,INTER,Receita com serviços,Outras,../data/raw/BANCO INTER-2023.xlsx
2023-08-22,PIX RECEBIDO RICARDO COSTANARO,,460.0,0.0,11073.27,INTER,Receita com serviços,Outras,../data/raw/BANCO INTER-2023.xlsx
2023-08-22,PIX RECEBIDO HELIETE SCHUTZ MILLACK,,90.0,0.0,11163.27,INTER,Receita com serviços,Outras,../data/raw/BANCO INTER-2023.xlsx
2023-08-22,PIX RECEBIDO LEOVALDIR MILLACK,,90.0,0.0,11253.27,INTER,Receita com serviços,Outras,../data/raw/BANCO INTER-2023.xlsx
2023-08-22,PIX RECEBIDO MARIA CECILIA MELGES DE CARVALHO,,460.0,0.0,11713.27,INTER,Receita com serviços,Outras,../data/raw/BANCO INTER-2023.xlsx
2023-08-22,PIX RECEBIDO RODRIGO FELIX DI GESU,,550.0,0.0,12263.27,INTER,Receita com serviços,Outras,../data/raw/BANCO INTER-2023.xlsx
2023-08-22,PIX RECEBIDO AUGUSTO CESAR VICTORIO,,260.0,0.0,12523.27,INTER,Receita com serviços,Outras,../data/raw/BANCO INTER-2023.xlsx
2023-08-23,PIX RECEBIDO SANTUZA MARIA M L CANCADO,,560.0,0.0,13083.27,INTER,Receita com serviços,Outras,../data/raw/BANCO INTER-2023.xlsx
2023-08-23,PIX RECEBIDO ADRIANA M A CORSETTI,,260.0,0.0,13343.27,INTER,Receita com serviços,Outras,../data/raw/BANCO INTER-2023.xlsx
2023-08-23,PIX RECEBIDO ALINE DA SILVA MARQUES,,260.0,0.0,13603.27,INTER,Receita com serviços,Outras,../data/raw/BANCO INTER-2023.xlsx
2023-08-24,PIX RECEBIDO MAYARA DE ASSIS GARCIA,,510.0,0.0,14113.27,INTER,Receita com serviços,Outras,../data/raw/BANCO INTER-2023.xlsx
2023-08-25,PIX RECEBIDO GABRIEL RIBEIRO MIRANDA,,260.0,0.0,14373.27,INTER,Receita com serviços,Outras,../data/raw/BANCO INTER-2023.xlsx
2023-08-28,PIX RECEBIDO FERNANDA VICCARI,,35.0,0.0,14408.27,INTER,Receita com serviços,Outras,../data/raw/BANCO INTER-2023.xlsx
2023-08-28,PIX RECEBIDO FABRICIO BORGES DE CAMPOS,,40.0,0.0,14448.27,INTER,Receita com serviços,Outras,../data/raw/BANCO INTER-2023.xlsx
2023-08-29,PIX RECEBIDO SHEYLA ROSANE DE ALMEIDA SANTOS,,490.0,0.0,14938.27,INTER,Receita com serviços,Outras,../data/raw/BANCO INTER-2023.xlsx
2023-08-30,PIX RECEBIDO LUIZ AUGUSTO DA SILVA VINHAL,,480.0,0.0,15418.27,INTER,Receita com serviços,Outras,../data/raw/BANCO INTER-2023.xlsx
2023-08-30,PIX RECEBIDO CLEIDE WIEZBICKI,,365.0,0.0,15783.27,INTER,Receita com serviços,Outras,../data/raw/BANCO INTER-2023.xlsx
2023-08-30,PIX RECEBIDO IDA MARCILIA DE ALCANTARA NAKATANI,,1000.0,0.0,16783.27,INTER,Receita com serviços,Outras,../data/raw/BANCO INTER-2023.xlsx
2023-08-30,PIX RECEBIDO ROSELI SCHERER,,160.0,0.0,16943.27,INTER,Receita com serviços,Outras,../data/raw/BANCO INTER-2023.xlsx
2023-08-31,PIX ENVIADO MATHEUS LAURENTINO DA ROSA - SERVIÇO PRESTADO,,0.0,220.0,16723.27,INTER,Despesa com pessoal,Salário,../data/raw/BANCO INTER-2023.xlsx
2023-08-31,PIX ENVIADO MATHEUS LAURENTINO DA ROSA - VT ESTAGIÁRIO,,0.0,228.0,16495.27,INTER,Despesa com pessoal,Transporte (VT),../data/raw/BANCO INTER-2023.xlsx
2023-08-31,PIX ENVIADO LUIZ GUILHERME KRAUSE,,0.0,200.0,16295.27,INTER,Despesa com pessoal,Salário,../data/raw/BANCO INTER-2023.xlsx
2023-09-01,PIX RECEBIDO CELIO PERON,,220.0,0.0,16515.27,INTER,Receita com serviços,Outras,../data/raw/BANCO INTER-2023.xlsx
2023-09-04,PIX ENVIADO LARYSSA - PAGTO DE SERVIÇOS PRESTADOS - TERCEIRO,,0.0,1700.0,14815.27,INTER,Despesa com pessoal,Salário,../data/raw/BANCO INTER-2023.xlsx
2023-09-04,PIX ENVIADO GOVERNO DO PARANA SECRETARIA DE ESTADO - GRPR,,0.0,89.7,14725.57,INTER,Despesas tributárias ,Outras,../data/raw/BANCO INTER-2023.xlsx
2023-09-04,PIX RECEBIDO APARECIDA REGINA LOPES,,40.0,0.0,14765.57,INTER,Receita com serviços,Outras,../data/raw/BANCO INTER-2023.xlsx
2023-09-06,PIX RECEBIDO MONTEMOR INVESTIMENTOS E PARTICIPACOE - NFS-e 2356,,700.0,0.0,15465.57,INTER,Receita com serviços,Outras,../data/raw/BANCO INTER-2023.xlsx
2023-09-06,PIX ENVIADO TATYANA CHAVIER - PAGAMENTO DE SALÁRIO,,0.0,1674.86,13790.71,INTER,Despesa com pessoal,Salário,../data/raw/BANCO INTER-2023.xlsx
2023-09-06,PIX ENVIADO ELISABETE - PAGTO PRO-LABORE,,0.0,1335.0,12455.71,INTER,Despesa com pessoal,Pró labore,../data/raw/BANCO INTER-2023.xlsx
2023-09-06,PIX ENVIADO SILVIA - PAGTO HONORÁRIOS CONTABILIDADE,,0.0,523.0,11932.71,INTER,Despesas administrativas,Contabilidade,../data/raw/BANCO INTER-2023.xlsx
2023-09-06,PIX ENVIADO THIAGO IANUCH MARIN - PAGAMENTO DE SALÁRIO,,0.0,1603.3,10329.41,INTER,Despesa com pessoal,Salário,../data/raw/BANCO INTER-2023.xlsx
2023-09-06,PIX ENVIADO CLAUDIO - PAGTO PRO-LABORE,,0.0,1335.0,8994.41,INTER,Despesa com pessoal,Pró labore,../data/raw/BANCO INTER-2023.xlsx
2023-09-06,PIX ENVIADO RENAN CRUZ - VT ESTAGIÁRIO,,0.0,216.0,8778.41,INTER,Despesa com pessoal,Transporte (VT),../data/raw/BANCO INTER-2023.xlsx
2023-09-06,PAGAMENTO CIEE - ESTAGIÁRIO,,0.0,500.19,8278.22,INTER,Despesa com pessoal,Salário,../data/raw/BANCO INTER-2023.xlsx
2023-09-06,PIX RECEBIDO NATHALY GONÇALVES LEODORO DOS SANTOS,,565.0,0.0,8843.22,INTER,Receita com serviços,Outras,../data/raw/BANCO INTER-2023.xlsx
2023-09-06,PIX RECEBIDO FABIANO NOVAK,,200.0,0.0,9043.22,INTER,Receita com serviços,Outras,../data/raw/BANCO INTER-2023.xlsx
2023-09-06,PIX RECEBIDO JOSÉ PAULO DE OLIVEIRA SPADA,,420.0,0.0,9463.22,INTER,Receita com serviços,Outras,../data/raw/BANCO INTER-2023.xlsx
2023-09-11,PIX RECEBIDO FRESNOMAQ INDUSTRIA DE MAQUINAS S/A - NFS-e 2350,,1454.0,0.0,10917.22,INTER,Receita com serviços,Outras,../data/raw/BANCO INTER-2023.xlsx
2023-09-11,PIX RECEBIDO EVA ELAINE BATISTA,,290.0,0.0,11207.22,INTER,Receita com serviços,Outras,../data/raw/BANCO INTER-2023.xlsx
2023-09-11,PIX RECEBIDO FRANCISCO IGLESIAS,,205.0,0.0,11412.22,INTER,Receita com serviços,Outras,../data/raw/BANCO INTER-2023.xlsx
2023-09-11,PIX ENVIADO Munhoz Munhoz Pizzaria Ltda Me - ATEND. ON-SITE PANASONIC,,0.0,75.5,11336.72,INTER,Despesa com pessoal,Alimentação (VR VA),../data/raw/BANCO INTER-2023.xlsx
2023-09-12,PIX RECEBIDO JULIA THIEMI MORIGAKI,,180.0,0.0,11516.72,INTER,Receita com serviços,Outras,../data/raw/BANCO INTER-2023.xlsx
2023-09-12,PIX RECEBIDO RAFAEL CRISTIANO QUEQUI (DIFERENÇA VENDA MOTO XRE300),,1000.0,0.0,12516.72,INTER,Receita de vendas,Outras vendas,../data/raw/BANCO INTER-2023.xlsx
2023-09-12,PIX ENVIADO NILTON WILMAR VOI - PAGTO DESPACHANTE REF. VENDA DA MOTO XRE300,,0.0,70.0,12446.72,INTER,Despesas administrativas,Outras,../data/raw/BANCO INTER-2023.xlsx
2023-09-12,COMPRA CARTÃO NO ESTABELECIMENTO CID ROCHA JUNIOR - CARTÓRIO VENDA MOTO XRE300,,0.0,23.69,12423.03,INTER,Despesas administrativas,Cartório,../data/raw/BANCO INTER-2023.xlsx
2023-09-12,COMPRA CARTÃO NO ESTABELECIMENTO PEDRO IGUAÇU - ,,0.0,31.0,12392.03,INTER,Despesa com pessoal,Alimentação (VR VA),../data/raw/BANCO INTER-2023.xlsx
2023-09-12,PIX ENVIADO DETRAN - MULTA DA MOTO,,0.0,262.92,12129.11,INTER,Despesas administrativas,Multas veiculos,../data/raw/BANCO INTER-2023.xlsx
2023-09-13,PIX RECEBIDO JACKSON LUIZ PEDRINI,,115.0,0.0,12244.11,INTER,Receita com serviços,Outras,../data/raw/BANCO INTER-2023.xlsx
2023-09-13,PIX RECEBIDO MARCELO JACINTO DE LIMA,,40.0,0.0,12284.11,INTER,Receita com serviços,Outras,../data/raw/BANCO INTER-2023.xlsx
2023-09-14,COMPRA CARTÃO NO ESTABELECIMENTO PAG*RECARGADECELULAR LUIZ,,0.0,12.0,12272.11,INTER,Despesas administrativas,"Telefonia (Celular, Fixo, Internet)",../data/raw/BANCO INTER-2023.xlsx
2023-09-14,COMPRA CARTÃO NO ESTABELECIMENTO PAG*RECARGADECELULAR ECEEL,,0.0,15.0,12257.11,INTER,Despesas administrativas,"Telefonia (Celular, Fixo, Internet)",../data/raw/BANCO INTER-2023.xlsx
2023-09-14,PIX RECEBIDO PAULO HENRIQUE UYARA DE CASTRO,,40.0,0.0,12297.11,INTER,Receita com serviços,Outras,../data/raw/BANCO INTER-2023.xlsx
2023-09-14,PIX RECEBIDO CHRISTINA ROCHA MACHADO,,260.0,0.0,12557.11,INTER,Receita com serviços,Outras,../data/raw/BANCO INTER-2023.xlsx
2023-09-14,PIX RECEBIDO MARYLENE GALIANO,,225.0,0.0,12782.11,INTER,Receita com serviços,Outras,../data/raw/BANCO INTER-2023.xlsx
2023-09-15,PIX RECEBIDO ALEXANDRE M SANCHES,,670.0,0.0,13452.11,INTER,Receita com serviços,Outras,../data/raw/BANCO INTER-2023.xlsx
2023-09-15,PIX RECEBIDO RAFAEL MAURICIO MIOLA,,220.0,0.0,13672.11,INTER,Receita com serviços,Outras,../data/raw/BANCO INTER-2023.xlsx
2023-09-18,PIX RECEBIDO RANULFO EGYDYO SOTOMAIOR,,145.0,0.0,13817.11,INTER,Receita com serviços,Outras,../data/raw/BANCO INTER-2023.xlsx
2023-09-18,PIX RECEBIDO CLAUDIA REGINA PAIVA,,650.0,0.0,14467.11,INTER,Receita com serviços,Outras,../data/raw/BANCO INTER-2023.xlsx
2023-09-18,PIX RECEBIDO LITORAL SUL CONVENIENCIA LTDA,,380.0,0.0,14847.11,INTER,Receita com serviços,Outras,../data/raw/BANCO INTER-2023.xlsx
2023-09-19,PIX RECEBIDO REBECA N C MILANEZI,,380.0,0.0,15227.11,INTER,Receita com serviços,Outras,../data/raw/BANCO INTER-2023.xlsx
2023-09-19,PIX RECEBIDO INUSITTA AMBIENTES PLANEJADOS LTDA,,890.0,0.0,16117.11,INTER,Receita com serviços,Outras,../data/raw/BANCO INTER-2023.xlsx
2023-09-19,PIX ENVIADO DETRAN - MULTA DA SPIN,,0.0,104.13,16012.98,INTER,Despesas administrativas,Multas veiculos,../data/raw/BANCO INTER-2023.xlsx
2023-09-20,PIX RECEBIDO ANDRE LUIZ OLIVEIRA NASCIMENTO,,60.0,0.0,16072.98,INTER,Receita com serviços,Outras,../data/raw/BANCO INTER-2023.xlsx
2023-09-20,PIX RECEBIDO SILVIE R BALZAN,,460.0,0.0,16532.98,INTER,Receita com serviços,Outras,../data/raw/BANCO INTER-2023.xlsx
2023-09-20,PIX RECEBIDO MARISA LOPES DE LIMA,,360.0,0.0,16892.98,INTER,Receita com serviços,Outras,../data/raw/BANCO INTER-2023.xlsx
2023-09-20,PIX RECEBIDO PEDRO NUNES ARRECHI,,140.0,0.0,17032.98,INTER,Receita com serviços,Outras,../data/raw/BANCO INTER-2023.xlsx
2023-09-20,PIX RECEBIDO MARCELO RODRIGUES GOMES,,40.0,0.0,17072.98,INTER,Receita com serviços,Outras,../data/raw/BANCO INTER-2023.xlsx
2023-09-20,PIX ENVIADO PAGTO CARTÃO INTER,,0.0,4491.84,12581.14,INTER,Outras Despesas ,Pgto fatura Cartão Credito,../data/raw/BANCO INTER-2023.xlsx
2023-09-20,PIX RECEBIDO THIAGO ANTONIO SOARES PINTO,,40.0,0.0,12621.14,INTER,Receita com serviços,Outras,../data/raw/BANCO INTER-2023.xlsx
2023-09-20,PIX ENVIADO WILLIAN LUCIANO PECANHA - INSTALAÇÃO DE CÂMERAS,,0.0,600.0,12021.14,INTER,Despesas administrativas,Outras,../data/raw/BANCO INTER-2023.xlsx
2023-09-20,PIX RECEBIDO GABRIEL LUAN RODRIGUES DE SOUZA,,592.0,0.0,12613.14,INTER,Receita com serviços,Outras,../data/raw/BANCO INTER-2023.xlsx
2023-09-21,PIX RECEBIDO GUILHERME BARRETO MOTA,,40.0,0.0,12653.14,INTER,Receita com serviços,Outras,../data/raw/BANCO INTER-2023.xlsx
2023-09-21,PIX RECEBIDO MARILI TEREZINHA P HENEQUIM,,20.0,0.0,12673.14,INTER,Receita com serviços,Outras,../data/raw/BANCO INTER-2023.xlsx
2023-09-21,PIX RECEBIDO MARILI TEREZINHA P HENEQUIM,,15.0,0.0,12688.14,INTER,Receita com serviços,Outras,../data/raw/BANCO INTER-2023.xlsx
2023-09-24,PIX ENVIADO BRUCE COSTA - CONSERTO PNEU CARRO (FIESTA),,0.0,40.0,12648.14,INTER,Despesas administrativas,Peças/acessórios veiculos,../data/raw/BANCO INTER-2023.xlsx
2023-09-25,PIX RECEBIDO ATELIE DESIGN COMERCIO LTDA,,340.0,0.0,12988.14,INTER,Receita com serviços,Outras,../data/raw/BANCO INTER-2023.xlsx
2023-09-25,PIX ENVIADO LUIZ GUILHERME - ALIMENTAÇÃO HORA EXTRAS,,0.0,30.0,12958.14,INTER,Despesa com pessoal,Alimentação (VR VA),../data/raw/BANCO INTER-2023.xlsx
2023-09-26,PIX RECEBIDO RODOLFO ARTHUR ZUCKERMANN,,470.0,0.0,13428.14,INTER,Receita com serviços,Outras,../data/raw/BANCO INTER-2023.xlsx
2023-09-26,PIX RECEBIDO POLIANE KARINE ROCHA PARREIRA,,35.0,0.0,13463.14,INTER,Receita com serviços,Outras,../data/raw/BANCO INTER-2023.xlsx
2023-09-26,PIX RECEBIDO LUIZ A CAPELARI,,200.0,0.0,13663.14,INTER,Receita com serviços,Outras,../data/raw/BANCO INTER-2023.xlsx
2023-09-27,PIX RECEBIDO WG CONSERTOS E ASSISTENCIA TECNICA LT,,80.0,0.0,13743.14,INTER,Receita com serviços,Outras,../data/raw/BANCO INTER-2023.xlsx
2023-09-27,PIX RECEBIDO INGRID MARQUES C OLIVEIRA MELO,,220.0,0.0,13963.14,INTER,Receita com serviços,Outras,../data/raw/BANCO INTER-2023.xlsx
2023-09-27,PIX RECEBIDO FLAVIO AUGUSTO ANDRE,,40.0,0.0,14003.14,INTER,Receita com serviços,Outras,../data/raw/BANCO INTER-2023.xlsx
2023-09-28,PIX RECEBIDO TERESINHA DE FATIMA GONCALVES DA SILVA,,260.0,0.0,14263.14,INTER,Receita com serviços,Outras,../data/raw/BANCO INTER-2023.xlsx
2023-09-29,PIX RECEBIDO ANDRE LUIZ RUFINO CORDEIRO,,430.0,0.0,14693.14,INTER,Receita com serviços,Outras,../data/raw/BANCO INTER-2023.xlsx
2023-09-29,PIX RECEBIDO NEUSA MARIA IRUME MAUGER,,180.0,0.0,14873.14,INTER,Receita com serviços,Outras,../data/raw/BANCO INTER-2023.xlsx
2023-10-02,PIX RECEBIDO GERMANA LOPES DA SILVA,,480.0,0.0,15353.14,INTER,Receita com serviços,Outras,../data/raw/BANCO INTER-2023.xlsx
2023-10-02,PIX RECEBIDO LUCAS MARTINS PEREIRA LIMA,,100.0,0.0,15453.14,INTER,Receita com serviços,Outras,../data/raw/BANCO INTER-2023.xlsx
2023-10-02,PIX RECEBIDO JOSELIA PINTO RODRIGUES,,190.0,0.0,15643.14,INTER,Receita com serviços,Outras,../data/raw/BANCO INTER-2023.xlsx
2023-10-02,COMPRA CARTÃO  POSTO HURACAN CURITIBA - COMBUSTÍVEL SPIN,,0.0,50.0,15593.14,INTER,Despesas administrativas,Combustivel,../data/raw/BANCO INTER-2023.xlsx
2023-10-02,PIX RECEBIDO BRUNA KELEN STHEFANI PETRES WILLEMANN,,40.0,0.0,15633.14,INTER,Receita com serviços,Outras,../data/raw/BANCO INTER-2023.xlsx
2023-10-02,PIX RECEBIDO SHEILA CRISTINA DO ROSARIO,,390.0,0.0,16023.14,INTER,Receita com serviços,Outras,../data/raw/BANCO INTER-2023.xlsx
2023-10-02,PAGAMENTO SELETROAR - PARCELA 3 DE 5,,0.0,92.79,15930.35,INTER,Outras Despesas ,Outras Despesas ,../data/raw/BANCO INTER-2023.xlsx
2023-10-02,PIX ENVIADO GOVERNO DO PARANA SECRETARIA DE ESTADO - GRPR,,0.0,689.66,15240.69,INTER,Despesas tributárias ,Outras,../data/raw/BANCO INTER-2023.xlsx
2023-10-03,PIX RECEBIDO SHAULA ZUCCHI,,430.0,0.0,15670.69,INTER,Receita com serviços,Outras,../data/raw/BANCO INTER-2023.xlsx
2023-10-04,PIX RECEBIDO ALECSANDRA HANEMANN ROYER,,180.0,0.0,15850.69,INTER,Receita com serviços,Outras,../data/raw/BANCO INTER-2023.xlsx
2023-10-04,COMPRA CARTÃO 5E CARTORIO DE NOTAS CURITIBA,,0.0,40.85,15809.84,INTER,Despesas administrativas,Cartório,../data/raw/BANCO INTER-2023.xlsx
2023-10-04,PIX RECEBIDO ANDRE MACHADO DO NASCIMENTO,,60.0,0.0,15869.84,INTER,Receita com serviços,Outras,../data/raw/BANCO INTER-2023.xlsx
2023-10-04,CDB CREDITO BANCO INTER - RESGATE,,8810.72,0.0,24680.56,INTER,Transferência (Crédito),Aplicação,../data/raw/BANCO INTER-2023.xlsx
2023-10-04,CDB CREDITO BANCO INTER - RESGATE,,1189.28,0.0,25869.84,INTER,Transferência (Crédito),Aplicação,../data/raw/BANCO INTER-2023.xlsx
2023-10-04,PIX ENVIADO CLAUDIO GALINDO,,0.0,10000.0,15869.84,INTER,Transferência (Débito),Reserva de Capital,../data/raw/BANCO INTER-2023.xlsx
2023-10-04,PIX RECEBIDO ASA MOTORS COMERCIO DE VEICULOS LTDA - VENDA DA SPIN,,30000.0,0.0,45869.84,INTER,Receita de vendas,Outras vendas,../data/raw/BANCO INTER-2023.xlsx
2023-10-04,PIX RECEBIDO JACSON ALBERTINO TAMPELLI,,25.0,0.0,45894.84,INTER,Receita com serviços,Outras,../data/raw/BANCO INTER-2023.xlsx
2023-10-05,PIX ENVIADO ANTONIO ODENIR FERRAZ - PAGTO 1ª PARTE RANGER,,0.0,30000.0,15894.84,INTER,Despesas administrativas,Veiculos,../data/raw/BANCO INTER-2023.xlsx
2023-10-06,PIX RECEBIDO LUCIANE CRISTINA ANTUNES,,110.5,0.0,16005.34,INTER,Receita com serviços,Outras,../data/raw/BANCO INTER-2023.xlsx
2023-10-06,PIX ENVIADO TATYANA - PAGAMENTO DE SALÁRIO,,0.0,1744.41,14260.93,INTER,Despesa com pessoal,Salário,../data/raw/BANCO INTER-2023.xlsx
2023-10-06,PIX ENVIADO CINTHYA - PAGAMENTO DE SALÁRIO,,0.0,1535.67,12725.26,INTER,Despesa com pessoal,Salário,../data/raw/BANCO INTER-2023.xlsx
2023-10-06,PIX ENVIADO THIAGO - PAGAMENTO DE SALÁRIO,,0.0,1606.66,11118.6,INTER,Despesa com pessoal,Salário,../data/raw/BANCO INTER-2023.xlsx
2023-10-06,NAKAYOSHI IMÓVEIS - PAGAMENTO DE ALUGUEL,,0.0,5100.91,6017.69,INTER,Despesas administrativas,Aluguel imóvel,../data/raw/BANCO INTER-2023.xlsx
2023-10-06,PIX RECEBIDO SILVIA MARIA MACEDO ALARCON,,180.0,0.0,6197.69,INTER,Receita com serviços,Outras,../data/raw/BANCO INTER-2023.xlsx
2023-10-06,PIX RECEBIDO ANGELO MUCELINI GIRO,,340.0,0.0,6537.69,INTER,Receita com serviços,Outras,../data/raw/BANCO INTER-2023.xlsx
2023-10-06,COMPRA CARTÃO - BALAROTI-  PARAFUSOS,,0.0,28.26,6509.43,INTER,Despesa com produtos,Materiais de Consumo,../data/raw/BANCO INTER-2023.xlsx
2023-10-09,COMPRA CARTÃO BANCA SILVA GARUVA - ALIMENTAÇÃO ATEND. PANASONIC,,0.0,74.7,6434.73,INTER,Despesa com pessoal,Alimentação (VR VA),../data/raw/BANCO INTER-2023.xlsx
2023-10-09,COMPRA CARTÃO GENNIUS BRASIL - ALIMENTAÇÃO ATEND. PANASONIC,,0.0,44.7,6390.03,INTER,Despesa com pessoal,Alimentação (VR VA),../data/raw/BANCO INTER-2023.xlsx
2023-10-09,COMPRA CARTÃO MILIUM LOJA - ,,0.0,17.94,6372.09,INTER,Outras Despesas ,Outras Despesas ,../data/raw/BANCO INTER-2023.xlsx
2023-10-09,COMPRA CARTÃO ADILZALEALRIBEIRO - ALIMENTAÇÃO ATEND. ON-SITE,,0.0,73.0,6299.09,INTER,Despesa com pessoal,Alimentação (VR VA),../data/raw/BANCO INTER-2023.xlsx
2023-10-09,COMPRA CARTÃO COM MAT C WR ALMEIDA,,0.0,29.5,6269.59,INTER,Despesas administrativas,Manutenção predial,../data/raw/BANCO INTER-2023.xlsx
2023-10-09,COMPRA CARTÃO COM MAT C WR ALMEIDA,,0.0,9.0,6260.59,INTER,Despesas administrativas,Manutenção predial,../data/raw/BANCO INTER-2023.xlsx
2023-10-09,PIX RECEBIDO ERIEL ALIRIO VOGT,,110.0,0.0,6370.59,INTER,Receita com serviços,Outras,../data/raw/BANCO INTER-2023.xlsx
2023-10-09,PIX RECEBIDO ADRIANA IORIO CATTANEO,,500.0,0.0,6870.59,INTER,Receita com serviços,Outras,../data/raw/BANCO INTER-2023.xlsx
2023-10-10,PIX RECEBIDO MARILI TEREZINHA P HENEQUIM,,20.0,0.0,6890.59,INTER,Receita com serviços,Outras,../data/raw/BANCO INTER-2023.xlsx
2023-10-10,PIX RECEBIDO CACIA APARECIDA BATISTA,,365.0,0.0,7255.59,INTER,Receita com serviços,Outras,../data/raw/BANCO INTER-2023.xlsx
2023-10-10,PIX RECEBIDO TELMA AP. WOSNIAK,,350.0,0.0,7605.59,INTER,Receita com serviços,Outras,../data/raw/BANCO INTER-2023.xlsx
2023-10-10,PIX RECEBIDO MARIA ODETE BERNI PARRO,,390.0,0.0,7995.59,INTER,Receita com serviços,Outras,../data/raw/BANCO INTER-2023.xlsx
2023-10-10,PIX RECEBIDO SILVIO LUIZ GUARIENTI ,,210.0,0.0,8205.59,INTER,Receita com serviços,Outras,../data/raw/BANCO INTER-2023.xlsx
2023-10-10,PIX RECEBIDO INNOVE T P LTDA NFS-e 2372,,500.0,0.0,8705.59,INTER,Receita com serviços,Outras,../data/raw/BANCO INTER-2023.xlsx
2023-10-10,PIX RECEBIDO MANOEL LUIS FRANÇA,,32.5,0.0,8738.09,INTER,Receita com serviços,Outras,../data/raw/BANCO INTER-2023.xlsx
2023-10-11,COMPRA CARTÃO - CID ROCHA JUNIOR - CARTÓRIO REC. DE FIRMA  ,,0.0,15.38,8722.71,INTER,Despesas administrativas,Cartório,../data/raw/BANCO INTER-2023.xlsx
2023-10-11,PAGAMENTO CARTÃO AMERICAN,,0.0,2447.07,6275.64,INTER,Outras Despesas ,Pgto fatura Cartão Credito,../data/raw/BANCO INTER-2023.xlsx
2023-10-11,PIX ENVIADO LAERTES JOSE ALVES VENTURA - CARTÓRIO TRANSF. CARRO RANGER,,0.0,520.0,5755.64,INTER,Despesas administrativas,Cartório,../data/raw/BANCO INTER-2023.xlsx
2023-10-11,PAGTO COPEL - ENERGIA LOJA 3,,0.0,158.45,5597.19,INTER,Despesas administrativas,Energia,../data/raw/BANCO INTER-2023.xlsx
2023-10-11,PAGTO COPEL - ENERGIA LOJA 4,,0.0,56.24,5540.95,INTER,Despesas administrativas,Energia,../data/raw/BANCO INTER-2023.xlsx
2023-10-11,PAGTO COPEL - ENERGIA LOJA 6,,0.0,472.7,5068.25,INTER,Despesas administrativas,Energia,../data/raw/BANCO INTER-2023.xlsx
2023-10-11,PIX RECEBIDO FABIANE DO AMARAL SCHEMBERGER,,350.0,0.0,5418.25,INTER,Receita com serviços,Outras,../data/raw/BANCO INTER-2023.xlsx
2023-10-11,PIX RECEBIDO ROSANE HAUER LEITNER,,365.0,0.0,5783.25,INTER,Receita com serviços,Outras,../data/raw/BANCO INTER-2023.xlsx
2023-10-16,PIX RECEBIDO ROSANA DE MOURA DA ROCHA DE OLIVEIRA,,120.0,0.0,5903.25,INTER,Receita com serviços,Outras,../data/raw/BANCO INTER-2023.xlsx
2023-10-17,PIX RECEBIDO OSMAR JOSÉ CORREIA JUNIOR,,200.0,0.0,6103.25,INTER,Receita com serviços,Outras,../data/raw/BANCO INTER-2023.xlsx
2023-10-19,PIX RECEBIDO URSULA MARIA SOARES DE SA,,480.0,0.0,6583.25,INTER,Receita com serviços,Outras,../data/raw/BANCO INTER-2023.xlsx
2023-10-19,PIX RECEBIDO JOSÉ VILMAR FONSECA DE MACEDO ME,,540.0,0.0,7123.25,INTER,Receita com serviços,Outras,../data/raw/BANCO INTER-2023.xlsx
2023-10-20,PIX RECEBIDO KARINA TUSI DE FREITAS,,645.0,0.0,7768.25,INTER,Receita com serviços,Outras,../data/raw/BANCO INTER-2023.xlsx
2023-10-20,PAGAMENTO CARTÃO INTER,,0.0,4065.68,3702.57,INTER,Outras Despesas ,Pgto fatura Cartão Credito,../data/raw/BANCO INTER-2023.xlsx
2023-10-20,PIX ENVIADO BRENDA - PAGTO ADIANTAMENTO DE SALÁRIO,,0.0,696.04,3006.53,INTER,Despesa com pessoal,Salário,../data/raw/BANCO INTER-2023.xlsx
2023-10-20,PIX ENVIADO LUIZ GUILHERME - PAGTO ADIANTAMENTO DE SALÁRIO,,0.0,800.0,2206.53,INTER,Despesa com pessoal,Salário,../data/raw/BANCO INTER-2023.xlsx
2023-10-20,PIX RECEBIDO JADSON DOS SANTOS ANDRADE,,340.0,0.0,2546.53,INTER,Receita com serviços,Outras,../data/raw/BANCO INTER-2023.xlsx
2023-10-20,PIX RECEBIDO VANUSA RODRIGUES DA SILVA,,15.0,0.0,2561.53,INTER,Receita com serviços,Outras,../data/raw/BANCO INTER-2023.xlsx
2023-10-20,PIX RECEBIDO TIAGO SENHORINI FERNANDES,,260.0,0.0,2821.53,INTER,Receita com serviços,Outras,../data/raw/BANCO INTER-2023.xlsx
2023-10-23,COMPRA CARTÃO LUCIANAFARIASDO MATINHOS - ALIMENTAÇÃO ATEND. ON-SITE,,0.0,35.9,2785.63,INTER,Despesa com pessoal,Alimentação (VR VA),../data/raw/BANCO INTER-2023.xlsx
2023-10-23,COMPRA CARTÃO NO SUPER-PRO,,0.0,45.67,2739.96,INTER,Outras Despesas ,Outras Despesas ,../data/raw/BANCO INTER-2023.xlsx
2023-10-23,COMPRA CARTÃO NO BALAROTI,,0.0,51.15,2688.81,INTER,Outras Despesas ,Outras Despesas ,../data/raw/BANCO INTER-2023.xlsx
2023-10-23,PIX RECEBIDO EDUARDO GONÇALVES,,460.0,0.0,3148.81,INTER,Receita com serviços,Outras,../data/raw/BANCO INTER-2023.xlsx
2023-10-23,PIX RECEBIDO GEOVANNI RODRIGO DE SOUZA,,580.0,0.0,3728.81,INTER,Receita com serviços,Outras,../data/raw/BANCO INTER-2023.xlsx
2023-10-24,PIX ENVIADO ROBSON - LANCHES HORAS EXTRAS,,0.0,30.0,3698.81,INTER,Despesa com pessoal,Alimentação (VR VA),../data/raw/BANCO INTER-2023.xlsx
2023-10-24,PIX ENVIADO LUIZ GUILHERME - LANCHE HORA EXTRAS,,0.0,15.0,3683.81,INTER,Despesa com pessoal,Alimentação (VR VA),../data/raw/BANCO INTER-2023.xlsx
2023-10-25,PIX RECEBIDO MAURO MARTINS TOSTA,,450.0,0.0,4133.81,INTER,Receita com serviços,Outras,../data/raw/BANCO INTER-2023.xlsx
2023-10-26,PIX ENVIADO CLAUDIO GALINDO - ADIANTAMENTO,,0.0,700.0,3433.81,INTER,Despesa com pessoal,Alimentação (VR VA),../data/raw/BANCO INTER-2023.xlsx
2023-10-27,PIX ENVIADO ON TECNOLOGIA DE MOBILIDADE (ESTAR),,0.0,30.0,3403.81,INTER,Despesa com pessoal,Transporte (VT),../data/raw/BANCO INTER-2023.xlsx
2023-10-27,PIX RECEBIDO ASTOM COMERCIO E SERVICOS PARA EL,,287.5,0.0,3691.31,INTER,Receita com serviços,Outras,../data/raw/BANCO INTER-2023.xlsx
2023-10-30,PIX RECEBIDO CONDOMINIO ED PETROPOLIS,,990.0,0.0,4681.31,INTER,Receita com serviços,Outras,../data/raw/BANCO INTER-2023.xlsx
2023-10-30,PIX RECEBIDO KATRIN ZEM,,220.0,0.0,4901.31,INTER,Receita com serviços,Outras,../data/raw/BANCO INTER-2023.xlsx
2023-11-01,PIX RECEBIDO CARLA MENDES HIDALGO OLIVEIRA,,1220.0,0.0,6121.31,INTER,Receita com serviços,Outras,../data/raw/BANCO INTER-2023.xlsx
2023-11-01,PIX RECEBIDO JONATHAN ROSA,,460.0,0.0,6581.31,INTER,Receita com serviços,Outras,../data/raw/BANCO INTER-2023.xlsx
2023-11-01,PIX RECEBIDO VALMIR CLASEM,,1000.0,0.0,7581.31,INTER,Receita com serviços,Outras,../data/raw/BANCO INTER-2023.xlsx
2023-11-01,PIX RECEBIDO SANDRO CALDEIRA LIMA,,460.0,0.0,8041.31,INTER,Receita com serviços,Outras,../data/raw/BANCO INTER-2023.xlsx
2023-11-01,COMPRA CARTÃO-MARLI RESTAURANTE-ATENDIMENTO ON-SITE PANASONIC,,0.0,49.9,7991.41,INTER,Despesa com pessoal,Alimentação (VR VA),../data/raw/BANCO INTER-2023.xlsx
2023-11-01,PIX RECEBIDO NADINI MEURER JUNCKES,,260.0,0.0,8251.41,INTER,Receita com serviços,Outras,../data/raw/BANCO INTER-2023.xlsx
2023-11-01,PIX RECEBIDO RODRIGO FERREIRA DOS REIS,,260.0,0.0,8511.41,INTER,Receita com serviços,Outras,../data/raw/BANCO INTER-2023.xlsx
2023-11-01,PIX RECEBIDO THIAGO MIGUEL DE OLIVEIRA,,220.0,0.0,8731.41,INTER,Receita com serviços,Outras,../data/raw/BANCO INTER-2023.xlsx
2023-11-01,COMPRA CARTÃO-GRUPO GENNIUS-ATENDIMENTO ON-SITE PANASONIC,,0.0,34.85,8696.56,INTER,Outras Despesas ,Outras Despesas ,../data/raw/BANCO INTER-2023.xlsx
2023-11-03,PIX ENVIADO GOVERNO DO PARANA SECRETARIA DE ESTADO - GRPR,,0.0,79.76,8616.8,INTER,Despesas tributárias ,Outras,../data/raw/BANCO INTER-2023.xlsx
2023-11-03,PIX RECEBIDO VIVIANE WAGNER FLUGEL,,37.5,0.0,8654.3,INTER,Receita com serviços,Outras,../data/raw/BANCO INTER-2023.xlsx
2023-11-04,PIX RECEBIDO PAULO SERGIO BAYER,,450.0,0.0,9104.3,INTER,Receita com serviços,Outras,../data/raw/BANCO INTER-2023.xlsx
2023-11-06,PIX RECEBIDO ANA PAULA FERREIRA ROSA,,225.0,0.0,9329.3,INTER,Receita com serviços,Outras,../data/raw/BANCO INTER-2023.xlsx
2023-11-06,PIX RECEBIDO CLEUNICE APARECIDA MATOSO,,75.0,0.0,9404.3,INTER,Receita com serviços,Outras,../data/raw/BANCO INTER-2023.xlsx
2023-11-06,PIX RECEBIDO OTAVIO FRANSOLINO ALVES,,1295.0,0.0,10699.3,INTER,Receita com serviços,Outras,../data/raw/BANCO INTER-2023.xlsx
2023-11-07,PIX ENVIADO TATYANA CHAVIER - PAGAMENTO DE SALÁRIO,,0.0,1721.11,8978.19,INTER,Despesa com pessoal,Salário,../data/raw/BANCO INTER-2023.xlsx
2023-11-07,PIX ENVIADO LUIZ GUILHERME KRAUSE - PAGAMENTO DE SALÁRIO,,0.0,1053.03,7925.16,INTER,Despesa com pessoal,Salário,../data/raw/BANCO INTER-2023.xlsx
2023-11-07,PIX ENVIADO THIAGO IANUCH MARIN - PAGAMENTO DE SALÁRIO,,0.0,1603.3,6321.86,INTER,Despesa com pessoal,Salário,../data/raw/BANCO INTER-2023.xlsx
2023-11-07,PIX ENVIADO ELISABETE SEOLIN GALINDO-PAGAMENTO PRO-LABORE,,0.0,1335.0,4986.86,INTER,Despesa com pessoal,Pró labore,../data/raw/BANCO INTER-2023.xlsx
2023-11-07,PIX ENVIADO CLAUDIO VINICIUS GALINDO-PAGAMENTO PRO-LABORE,,0.0,1335.0,3651.86,INTER,Despesa com pessoal,Pró labore,../data/raw/BANCO INTER-2023.xlsx
2023-11-08,PIX RECEBIDO CARLOS GUILHERME C HAUCK,,260.0,0.0,3911.86,INTER,Receita com serviços,Outras,../data/raw/BANCO INTER-2023.xlsx
2023-11-08,PAGAMENTO CIEE - ESTAGIÁRIOS,,0.0,733.38,3178.48,INTER,Despesa com pessoal,Salário,../data/raw/BANCO INTER-2023.xlsx
2023-11-09,PIX RECEBIDO SERGIO ALVES DE ANDRADE,,120.0,0.0,3298.48,INTER,Receita com serviços,Outras,../data/raw/BANCO INTER-2023.xlsx
2023-11-09,PAGAMENTO BOLETO WHITE MARTINS,,0.0,39.76,3258.72,INTER,Despesa com produtos,Materiais de Consumo,../data/raw/BANCO INTER-2023.xlsx
2023-11-09,PIX RECEBIDO MIRELLA P BERTINATTI,,110.0,0.0,3368.72,INTER,Receita com serviços,Outras,../data/raw/BANCO INTER-2023.xlsx
2023-11-10,PIX RECEBIDO GUILHERME MONTEIRO RAMOS NETO,,96.59,0.0,3465.31,INTER,Receita com serviços,Outras,../data/raw/BANCO INTER-2023.xlsx
2023-11-10,PIX ENVIADO KAIO SPURI LIMA - PAGTO VT ESTAGIÁRIO,,0.0,216.0,3249.31,INTER,Despesa com pessoal,Transporte (VT),../data/raw/BANCO INTER-2023.xlsx
2023-11-11,PIX RECEBIDO MONICA PEREIRA MENDES PAZ,,220.0,0.0,3469.31,INTER,Receita com serviços,Outras,../data/raw/BANCO INTER-2023.xlsx
2023-11-12,PIX ENVIADO ROBSON FERNANDES - REF. URBER EM SÃO PAULO (TREINAMENTO MIDEA),,0.0,84.92,3384.39,INTER,Despesa com pessoal,Transporte (VT),../data/raw/BANCO INTER-2023.xlsx
2023-11-13,PIX RECEBIDO MARIANA MOURA ZANIN,,370.0,0.0,3754.39,INTER,Receita com serviços,Outras,../data/raw/BANCO INTER-2023.xlsx
2023-11-13,TED RECEBIDA ABREE - ASSOCIACAO BRASILEIRA NF-e 4399,,1386.44,0.0,5140.83,INTER,Receita com serviços,Outras,../data/raw/BANCO INTER-2023.xlsx
2023-11-13,PIX RECEBIDO LUCIENE CANO M. C. -. S. I. ADVOCACIA,,260.0,0.0,5400.83,INTER,Receita com serviços,Outras,../data/raw/BANCO INTER-2023.xlsx
2023-11-14,PIX RECEBIDO WG CONSERTOS E ASSISTENCIA TECNICA,,175.0,0.0,5575.83,INTER,Receita com serviços,Outras,../data/raw/BANCO INTER-2023.xlsx
2023-11-14,PAGAMENTO CARTÃO AMEX,,0.0,3098.34,2477.49,INTER,Outras Despesas ,Pgto fatura Cartão Credito,../data/raw/BANCO INTER-2023.xlsx
2023-11-14,PIX ENVIADO LUIZ GUILHERME - LANCHE HORA EXTRAS,,0.0,29.0,2448.49,INTER,Despesa com pessoal,Alimentação (VR VA),../data/raw/BANCO INTER-2023.xlsx
2023-11-14,PIX RECEBIDO JACIRA MARA GONÇALVES,,1000.0,0.0,3448.49,INTER,Receita com serviços,Outras,../data/raw/BANCO INTER-2023.xlsx
2023-11-14,PIX RECEBIDO RAFHAEL WITKOSKI,,145.5,0.0,3593.99,INTER,Receita com serviços,Outras,../data/raw/BANCO INTER-2023.xlsx
2023-11-16,PIX RECEBIDO NEIVA MARIA PILONI,,365.0,0.0,3958.99,INTER,Receita com serviços,Outras,../data/raw/BANCO INTER-2023.xlsx
2023-11-17,PIX RECEBIDO ROZANGELA SOUZA GODEIRO,,110.0,0.0,4068.99,INTER,Receita com serviços,Outras,../data/raw/BANCO INTER-2023.xlsx
2023-11-17,PIX RECEBIDO WILLIAM DE SÁ RIBAS,,670.0,0.0,4738.99,INTER,Receita com serviços,Outras,../data/raw/BANCO INTER-2023.xlsx
2023-11-17,PIX RECEBIDO MANOEL LUIS FRANCA,,47.5,0.0,4786.49,INTER,Receita com serviços,Outras,../data/raw/BANCO INTER-2023.xlsx
2023-11-18,PIX RECEBIDO MARCELO DE SOUZA RODRIGUES,,220.0,0.0,5006.49,INTER,Receita com serviços,Outras,../data/raw/BANCO INTER-2023.xlsx
2023-11-20,PAGTO CARTÃO INTER,,0.0,4441.22,565.27,INTER,Outras Despesas ,Pgto fatura Cartão Credito,../data/raw/BANCO INTER-2023.xlsx
2023-11-23,PIX RECEBIDO HELDNER LESEUX,,40.0,0.0,605.27,INTER,Receita com serviços,Outras,../data/raw/BANCO INTER-2023.xlsx
2023-11-23,PIX RECEBIDO DAYANE SANTOS CHEGOSKI,,180.0,0.0,785.27,INTER,Receita com serviços,Outras,../data/raw/BANCO INTER-2023.xlsx
2023-11-24,PIX RECEBIDO DIEGO NIKOLAS FERREIRA DOMINGUES,,40.0,0.0,825.27,INTER,Receita com serviços,Outras,../data/raw/BANCO INTER-2023.xlsx
2023-11-27,PIX RECEBIDO VIVIANE WAGNER FLUGEL,,12.5,0.0,837.77,INTER,Receita com serviços,Outras,../data/raw/BANCO INTER-2023.xlsx
2023-11-27,PIX RECEBIDO CLAUDIO TESTONI CARDOZO,,690.0,0.0,1527.77,INTER,Receita com serviços,Outras,../data/raw/BANCO INTER-2023.xlsx
2023-11-27,PIX RECEBIDO CLAUDIO TESTONI CARDOZO,,40.0,0.0,1567.77,INTER,Receita com serviços,Outras,../data/raw/BANCO INTER-2023.xlsx
2023-11-27,PIX RECEBIDO CARLA DE FATIMA RIBEIRO,,365.0,0.0,1932.77,INTER,Receita com serviços,Outras,../data/raw/BANCO INTER-2023.xlsx
2023-11-27,PIX RECEBIDO PABLO HERNANDES P VIEIRA,,40.0,0.0,1972.77,INTER,Receita com serviços,Outras,../data/raw/BANCO INTER-2023.xlsx
2023-11-28,PIX RECEBIDO DIELLE DIAS ADVOGADOS ASSOCIADOS,,365.0,0.0,2337.77,INTER,Receita com serviços,Outras,../data/raw/BANCO INTER-2023.xlsx
2023-11-28,PIX ENVIADO LUIZ - LANCHE HORAS EXTRAS,,0.0,30.0,2307.77,INTER,Despesa com pessoal,Alimentação (VR VA),../data/raw/BANCO INTER-2023.xlsx
2023-11-28,PIX ENVIADO ROBSON - LANCHE HORAS EXTRAS,,0.0,45.0,2262.77,INTER,Despesa com pessoal,Alimentação (VR VA),../data/raw/BANCO INTER-2023.xlsx
2023-11-29,PIX RECEBIDO ADRIANA APARECIDA SARTORI,,40.0,0.0,2302.77,INTER,Receita com serviços,Outras,../data/raw/BANCO INTER-2023.xlsx
2023-11-29,PIX ENVIADO WILSON CRUL - CONSERTO DO PNEU FIESTA,,0.0,40.0,2262.77,INTER,Despesas administrativas,Manutenção veículo,../data/raw/BANCO INTER-2023.xlsx
2023-11-29,PIX RECEBIDO LPC RESTAURANTE LTDA,,750.0,0.0,3012.77,INTER,Receita com serviços,Outras,../data/raw/BANCO INTER-2023.xlsx
2023-11-29,PIX RECEBIDO CARLOS JOSÉ DOS SANTOS,,226.0,0.0,3238.77,INTER,Receita com serviços,Outras,../data/raw/BANCO INTER-2023.xlsx
2023-11-29,PIX RECEBIDO WG CONSERTOS E ASSISTENCIA TECNICA,,175.0,0.0,3413.77,INTER,Receita com serviços,Outras,../data/raw/BANCO INTER-2023.xlsx
2023-11-29,PIX RECEBIDO MARILU SILVA SANTOS,,350.0,0.0,3763.77,INTER,Receita com serviços,Outras,../data/raw/BANCO INTER-2023.xlsx
2023-11-30,PIX RECEBIDO HENRIQUE ZIMPEL SANTOS,,350.0,0.0,4113.77,INTER,Receita com serviços,Outras,../data/raw/BANCO INTER-2023.xlsx
2023-11-30,PIX ENVIADO TATYANA CHAVIER - Adiantamento 13º salário,,0.0,957.09,3156.68,INTER,Despesa com pessoal,Salário,../data/raw/BANCO INTER-2023.xlsx
2023-12-01,PIX RECEBIDO NATASHA KAROLYNE WAWRUK,,50.0,0.0,3206.68,INTER,Receita com serviços,Outras,../data/raw/BANCO INTER-2023.xlsx
2023-12-01,PIX RECEBIDO RIO SUL ELTROMOVEIS LTDA,,595.0,0.0,3801.68,INTER,Receita com serviços,Outras,../data/raw/BANCO INTER-2023.xlsx
2023-12-01,PIX RECEBIDO ELSON CARLOS GOLOMBIEWSKI,,435.0,0.0,4236.68,INTER,Receita com serviços,Outras,../data/raw/BANCO INTER-2023.xlsx
2023-12-01,PIX RECEBIDO LEONARDO SANTOS DE ABREU,,220.0,0.0,4456.68,INTER,Receita com serviços,Outras,../data/raw/BANCO INTER-2023.xlsx
2023-12-04,PIX RECEBIDO ILMA LIMA DE SOUZA,,220.0,0.0,4676.68,INTER,Receita com serviços,Outras,../data/raw/BANCO INTER-2023.xlsx
2023-12-04,COMPRA CARTÃO JOSEALDENITAVARES CURITIBA,,0.0,35.0,4641.68,INTER,Outras Despesas ,Outras Despesas ,../data/raw/BANCO INTER-2023.xlsx
2023-12-04,COMPRA CARTÃO VILA IZABEL MATERIAIS CONSTRUÇÃO,,0.0,37.0,4604.68,INTER,Despesas administrativas,Manutenção predial,../data/raw/BANCO INTER-2023.xlsx
2023-12-04,PIX ENVIA SILVIA - PAGTO CONTABILIDADE,,0.0,1046.0,3558.68,INTER,Despesas administrativas,Contabilidade,../data/raw/BANCO INTER-2023.xlsx
2023-12-05,PIX RECEBIDO MONICA PEREIRA MENDES PAZ,,220.0,0.0,3778.68,INTER,Receita com serviços,Outras,../data/raw/BANCO INTER-2023.xlsx
2023-12-05,PIX RECEBIDO VANESSA DE SOUZA MENDONCA,,360.0,0.0,4138.68,INTER,Receita com serviços,Outras,../data/raw/BANCO INTER-2023.xlsx
2023-12-05,PIX ENVIADO LARYSSA - SERVIÇOS PRESTADOS - TERCEIRO,,0.0,2530.08,1608.6,INTER,Despesa com pessoal,Salário,../data/raw/BANCO INTER-2023.xlsx
2023-12-06,PIX RECEBIDO LINO PINTO FERREIRA,,445.0,0.0,2053.6,INTER,Receita com serviços,Outras,../data/raw/BANCO INTER-2023.xlsx
2023-12-06,PIX RECEBIDO CASSIA FABIANE DA CUNHA,,425.0,0.0,2478.6,INTER,Receita com serviços,Outras,../data/raw/BANCO INTER-2023.xlsx
2023-12-06,PIX ENVIADO THIAGO - PAGTO DE SALÁRIO,,0.0,1603.3,875.3,INTER,Despesa com pessoal,Salário,../data/raw/BANCO INTER-2023.xlsx
2023-12-06,PIX ENVIADO BRENDA - PAGTO DE SALÁRIO,,0.0,832.68,42.62,INTER,Despesa com pessoal,Salário,../data/raw/BANCO INTER-2023.xlsx
2023-12-06,PIX RECEBIDO ADRIANA CAMARGO DE ALMEIDA OLIVEIRA,,115.0,0.0,157.62,INTER,Receita com serviços,Outras,../data/raw/BANCO INTER-2023.xlsx
2023-12-06,PIX RECEBIDO LUCAS VILLELA SINNOTT,,55.0,0.0,212.62,INTER,Receita com serviços,Outras,../data/raw/BANCO INTER-2023.xlsx
2023-12-06,PIX RECEBIDO HELGA SZENBERG,,340.0,0.0,552.62,INTER,Receita com serviços,Outras,../data/raw/BANCO INTER-2023.xlsx
2023-12-06,COMPRA CARTÃO CID ROCHA JUNIOR - CARTÓRIO,,0.0,39.06,513.56,INTER,Despesas administrativas,Cartório,../data/raw/BANCO INTER-2023.xlsx
2023-12-06,PIX RECEBIDO PAULO SERGIO TAPIAS DE PONTES,,875.0,0.0,1388.56,INTER,Receita com serviços,Outras,../data/raw/BANCO INTER-2023.xlsx
2023-12-07,PIX ENVIADO VANESSA DE SOUZA MENDONCA -DEVOLUÇÃO DE PIX RECEBIDO 05/12,,0.0,360.0,1028.56,INTER,Transferência (Débito),Transferência / Reembolso,../data/raw/BANCO INTER-2023.xlsx
2023-12-10,PIX ENVIADO RONALDO FIRMINO DE FARIAS - PAGTO DE VALE TRANSPORTE,,0.0,161.0,867.56,INTER,Despesa com pessoal,Transporte (VT),../data/raw/BANCO INTER-2023.xlsx
2023-12-11,PIX ENVIADO NICOLAS FALAVINHA CHRISTINO PAGTO DE VALE TRANSPORTE,,0.0,168.0,699.56,INTER,Despesa com pessoal,Transporte (VT),../data/raw/BANCO INTER-2023.xlsx
2023-12-11,PIX RECEBIDO MAYARA DO CARMO RAMOS,,910.0,0.0,1609.56,INTER,Receita com serviços,Outras,../data/raw/BANCO INTER-2023.xlsx
2023-12-12,PIX RECEBIDO JULIA SILVEIRA,,510.0,0.0,2119.56,INTER,Receita com serviços,Outras,../data/raw/BANCO INTER-2023.xlsx
2023-12-14,COMPRA CARTÃO MATERIAIS CONSTRUÇÃO VILA IZABEL,,0.0,12.0,2107.56,INTER,Despesas administrativas,Manutenção predial,../data/raw/BANCO INTER-2023.xlsx
2023-12-14,PIX RECEBIDO ELIZABETH GUIMARÃES,,80.0,0.0,2187.56,INTER,Receita com serviços,Outras,../data/raw/BANCO INTER-2023.xlsx
2023-12-14,PIX RECEBIDO EDUARDO TAKEICHI OKAZAKI,,230.0,0.0,2417.56,INTER,Receita com serviços,Outras,../data/raw/BANCO INTER-2023.xlsx
2023-12-14,PIX RECEBIDO H POMPEU CONSULTORIA AUTORIZADA LTDA,,270.0,0.0,2687.56,INTER,Receita com serviços,Outras,../data/raw/BANCO INTER-2023.xlsx
2023-12-15,PIX RECEBIDO SUELI DO ROCIO ROGOWSKI,,300.0,0.0,2987.56,INTER,Receita com serviços,Outras,../data/raw/BANCO INTER-2023.xlsx
2023-12-18,PIX RECEBIDO ORANDINA ALBERTON DISNER,,1200.0,0.0,4187.56,INTER,Receita com serviços,Outras,../data/raw/BANCO INTER-2023.xlsx
2023-12-18,PIX RECEBIDO ANA PAULA LUZ DE ALMEIDA,,40.0,0.0,4227.56,INTER,Receita com serviços,Outras,../data/raw/BANCO INTER-2023.xlsx
2023-12-19,PIX RECEBIDO JORDANA ANGELICA ROHR LOBO,,1681.4,0.0,5908.96,INTER,Receita com serviços,Outras,../data/raw/BANCO INTER-2023.xlsx
2023-12-20,PIX RECEBIDO FERNANDA SARAIVA E SILVA,,500.0,0.0,6408.96,INTER,Receita com serviços,Outras,../data/raw/BANCO INTER-2023.xlsx
2023-12-20,PIX RECEBIDO MARCOS JOSÉ SUSLA,,250.0,0.0,6658.96,INTER,Receita com serviços,Outras,../data/raw/BANCO INTER-2023.xlsx
2023-12-20,PIX RECEBIDO GISELE CRISTINA DOS SANTOS,,860.0,0.0,7518.96,INTER,Receita com serviços,Outras,../data/raw/BANCO INTER-2023.xlsx
2023-12-21,PIX ENVIADO PAGTO CARTÃO INTER,,0.0,3382.55,4136.41,INTER,Outras Despesas ,Pgto fatura Cartão Credito,../data/raw/BANCO INTER-2023.xlsx
2023-12-22,PIX ENVIADO ON TECNOLOGIA DE MOBILIDADE URBANA - ESTAR,,0.0,30.0,4106.41,INTER,Despesa com pessoal,Transporte (VT),../data/raw/BANCO INTER-2023.xlsx
2023-12-22,PIX RECEBIDO DANIEL DAMIN,,225.0,0.0,4331.41,INTER,Receita com serviços,Outras,../data/raw/BANCO INTER-2023.xlsx
2023-12-22,PIX RECEBIDO WILLIANS TEIXEIRA,,120.0,0.0,4451.4,INTER,Receita com serviços,Outras,../data/raw/BANCO INTER-2023.xlsx
2023-12-22,PIX RECEBIDO DIMAS NOVAIS DA SILVA,,220.0,0.0,4671.41,INTER,Receita com serviços,Outras,../data/raw/BANCO INTER-2023.xlsx
2023-12-26,PIX RECEBIDO COND RESID LE PARC,,50.0,0.0,4721.41,INTER,Receita com serviços,Outras,../data/raw/BANCO INTER-2023.xlsx
2023-12-26,PIX RECEBIDO AUTO POSTO JATOBA LTDA,,1667.0,0.0,6388.41,INTER,Receita com serviços,Outras,../data/raw/BANCO INTER-2023.xlsx
2023-12-27,PIX RECEBIDO LUIZ CARLOS PESSOA ALBINI,,932.0,0.0,7320.41,INTER,Receita com serviços,Outras,../data/raw/BANCO INTER-2023.xlsx
2023-12-28,PIX RECEBIDO DANIEL DAMIN,,225.0,0.0,7545.41,INTER,Receita com serviços,Outras,../data/raw/BANCO INTER-2023.xlsx
2023-12-28,PIX ENVIADO ASSOCIAÇÃO METROCARD - PAGTO VT RONALDO,,0.0,100.65,7444.76,INTER,Despesa com pessoal,Transporte (VT),../data/raw/BANCO INTER-2023.xlsx
2023-12-29,PIX ENVIADO NICOLAS FALAVINHA CHRISTINO - PAGTO VT,,0.0,252.0,7192.76,INTER,Despesa com pessoal,Transporte (VT),../data/raw/BANCO INTER-2023.xlsx
2023-12-29,PIX ENVIADO KAIO SPURI LIMA - PAGTO VT ESTAGIÁRIO,,0.0,252.0,6940.76,INTER,Despesa com pessoal,Transporte (VT),../data/raw/BANCO INTER-2023.xlsx
2023-12-29,PIX RECEBIDO INOVE ESTOFADOS LTDA,,414.0,0.0,7354.76,INTER,Receita com serviços,Outras,../data/raw/BANCO INTER-2023.xlsx
2023-12-29,COMPRA CARTÃO  PRFARMA - SEDEX ENVIO DOCUMENTO P/ TATYANA,,0.0,70.4,7284.36,INTER,Despesas administrativas,Correios,../data/raw/BANCO INTER-2023.xlsx
2023-01-04,PAG BOLETO VR BENEFÍCIOS,41209,0.0,780.0,"10.810,63",CAIXA,Despesa com pessoal,Alimentação (VR VA),../data/raw/BANCO CAIXA - 2023.xlsx
2023-01-04,PAG BOLETO VT ESTAGIÁRIOS LUCAS E MATEUS,41212,0.0,464.94,"10.345,69",CAIXA,Despesa com pessoal,Transporte (VT),../data/raw/BANCO CAIXA - 2023.xlsx
2023-01-04,ENVIO PIX PAGTO VT ESTAGIÁRIO EDUARDO,41420,0.0,231.0,"10.114,69",CAIXA,Despesa com pessoal,Transporte (VT),../data/raw/BANCO CAIXA - 2023.xlsx
2023-01-04,ENVIO PIX PAGTO VT ESTAGIÁRIO MATHEUS,41425,0.0,231.0,"9.883,69",CAIXA,Despesa com pessoal,Transporte (VT),../data/raw/BANCO CAIXA - 2023.xlsx
2023-01-05,DB CEST PJ,122022,0.0,69.0,"9.814,69",CAIXA,Despesas financeiras,Despesas com cobrança,../data/raw/BANCO CAIXA - 2023.xlsx
2023-01-06,DEB P FGTS,564074,0.0,1361.51,"8.453,18",CAIXA,Despesa com pessoal,FGTS,../data/raw/BANCO CAIXA - 2023.xlsx
2023-01-06,ENVIO TEV LUAN - PAGTO DE SALÁRIO ,61105,0.0,569.79,"7.883,39",CAIXA,Despesa com pessoal,Salário,../data/raw/BANCO CAIXA - 2023.xlsx
2023-01-06,ENVIO TEV ROBSON - PAGTO DE SALÁRIO ,61108,0.0,1298.64,"6.584,75",CAIXA,Despesa com pessoal,Salário,../data/raw/BANCO CAIXA - 2023.xlsx
2023-01-06,ENVIO PIX OSIEL - PAGTO DE SALÁRIO,61116,0.0,1389.82,"5.194,93",CAIXA,Despesa com pessoal,Salário,../data/raw/BANCO CAIXA - 2023.xlsx
2023-01-06,ENVIO PIX THIAGO - PAGTO DE SALÁRIO,61116,0.0,1024.23,"4.170,70",CAIXA,Despesa com pessoal,Salário,../data/raw/BANCO CAIXA - 2023.xlsx
2023-01-06,ENVIO PIX ELISABETE - PRO-LABORE,61116,0.0,1078.68,"3.092,02",CAIXA,Despesa com pessoal,Pró labore,../data/raw/BANCO CAIXA - 2023.xlsx
2023-01-06,ENVIO PIX CLAUDIO - PRO-LABORE,61116,0.0,1078.68,"2.013,34",CAIXA,Despesa com pessoal,Pró labore,../data/raw/BANCO CAIXA - 2023.xlsx
2023-01-09,ENVIO PIX - PAGTO HONORÁRIOS CONTABILIDADE,91210,0.0,769.5,"1.243,84",CAIXA,Despesas administrativas,Contabilidade,../data/raw/BANCO CAIXA - 2023.xlsx
2023-01-09,PAG FGTS - DIFERENÇA RESCISÃO DA MARINA,91726,0.0,5.06,"1.238,78",CAIXA,Despesa com pessoal,FGTS,../data/raw/BANCO CAIXA - 2023.xlsx
2023-01-09,ENVIO TEV MARINA - DIFERENÇA RESCISÃO,91821,0.0,252.02,"986,76",CAIXA,Despesa com pessoal,Aviso prévio / Multa rescisória,../data/raw/BANCO CAIXA - 2023.xlsx
2023-01-10,CRED TED PANASONIC DO BRASIL LIMITADA NFS-e 2247,341,4469.55,0.0,"5.456,31",CAIXA,Receita com serviços,Panasonic,../data/raw/BANCO CAIXA - 2023.xlsx
2023-01-10,ENVIO PIX JACLEILSON - PAGTO TERCEIROS,101833,0.0,575.3,"4.881,01",CAIXA,Despesa com serviços,Mão de obra,../data/raw/BANCO CAIXA - 2023.xlsx
2023-01-13,PAG BOLETO - CARTÃO AMERICAN,131129,0.0,1286.09,"3.594,92",CAIXA,Despesas administrativas,Outras,../data/raw/BANCO CAIXA - 2023.xlsx
2023-01-13,ENVIO PIX MAIKO - PAGTO DE TERCEIROS,131934,0.0,466.92,"3.128,00",CAIXA,Despesa com serviços,Mão de obra,../data/raw/BANCO CAIXA - 2023.xlsx
2023-01-18,CRED TED SPRINGER CARRIER LTDA NFS-e 2254,341,13473.81,0.0,"16.601,81",CAIXA,Receita com serviços,Spring,../data/raw/BANCO CAIXA - 2023.xlsx
2023-01-20,PG ORG GOV - DARF/GPS,116469,0.0,1363.95,"15.237,86",CAIXA,Despesa com pessoal,INSS,../data/raw/BANCO CAIXA - 2023.xlsx
2023-01-20,PG ORG GOV DARF - IRRF REF ALUGUEL IMÓVEL,116853,0.0,84.58,"15.153,28",CAIXA,Despesas administrativas,Aluguel imóvel,../data/raw/BANCO CAIXA - 2023.xlsx
2023-01-20,PAG BOLETO CARTÃO INTER,446357,0.0,2564.93,"12.588,35",CAIXA,Despesas administrativas,Outras,../data/raw/BANCO CAIXA - 2023.xlsx
2023-01-20,PG ORG GOV DAS,497655,0.0,1961.9,"10.626,45",CAIXA,Despesas tributárias ,Outras,../data/raw/BANCO CAIXA - 2023.xlsx
2023-01-20,ENVIO TEV LUAN - PAGTO ADIANTAMENTO DE SALÁRIO,201504,0.0,673.54,"9.952,91",CAIXA,Despesa com pessoal,Salário,../data/raw/BANCO CAIXA - 2023.xlsx
2023-01-26,CRED TED - PAGSEGURO INTERNET LTDA,290,597.09,0.0,"10.550,00",CAIXA,Outras entradas,Receita não identificada,../data/raw/BANCO CAIXA - 2023.xlsx
2023-01-27,ENVIO TEV LUAN - PAGTO DE RESCISÃO,271545,0.0,854.8,"9.695,20",CAIXA,Despesa com pessoal,Aviso prévio / Multa rescisória,../data/raw/BANCO CAIXA - 2023.xlsx
2023-01-30,CRED TED SPRINGER CARRIER LTDA NFS-e 2261,341,1346.12,0.0,"11.041,32",CAIXA,Receita com serviços,Spring,../data/raw/BANCO CAIXA - 2023.xlsx
2023-01-31,PAG BOLETO VT ESTAGIÁRIOS  MATEUS,10029,0.0,211.94,"10.829,38",CAIXA,Despesa com pessoal,Transporte (VT),../data/raw/BANCO CAIXA - 2023.xlsx
2023-02-01,CRED TED FRESNOMAQ INDUSTRIA DE MAQUINA NFS-e 2256,341,2028.0,0.0,"12.857,38",CAIXA,Receita com serviços,Fresnomaq,../data/raw/BANCO CAIXA - 2023.xlsx
2023-02-03,CRED TED - PAGSEGURO INTERNET LTDA,290,1531.98,0.0,"14.389,36",CAIXA,Outras entradas,Receita não identificada,../data/raw/BANCO CAIXA - 2023.xlsx
2023-02-03,CRED PIX HORFRAN COM ELETRO MOVEIS NF-e 4089 e 4090 e NFS-e 2260,31606,360.0,0.0,"14.749,36",CAIXA,Receita com serviços,Outras,../data/raw/BANCO CAIXA - 2023.xlsx
2023-02-03,PAG AGUA,357035,0.0,166.15,"14.583,21",CAIXA,Despesas administrativas,Água,../data/raw/BANCO CAIXA - 2023.xlsx
2023-02-03,PAG BOLETO DUFRIO,540240,0.0,307.81,"14.275,40",CAIXA,Despesa com serviços,Outras,../data/raw/BANCO CAIXA - 2023.xlsx
2023-02-06,SAQUE LOT P/ PAGTO DIVERSOS,61559,0.0,1000.0,"13.275,40",CAIXA,Despesas administrativas,Outras,../data/raw/BANCO CAIXA - 2023.xlsx
2023-02-06,DEB P FGTS,511333,0.0,980.6,"12.294,80",CAIXA,Despesa com pessoal,FGTS,../data/raw/BANCO CAIXA - 2023.xlsx
2023-02-06,ENVIO TEV ROBSON - PAGTO DE SALÁRIO,61144,0.0,1854.78,"10.440,02",CAIXA,Despesa com pessoal,Salário,../data/raw/BANCO CAIXA - 2023.xlsx
2023-02-06,ENVIO PIX JACLEILSON - PAGTO DE SALÁRIO,61148,0.0,1605.29,"8.834,73",CAIXA,Despesa com pessoal,Salário,../data/raw/BANCO CAIXA - 2023.xlsx
2023-02-06,ENVIO PIX OSIEL - PAGTO DE SALÁRIO,61219,0.0,1987.74,"6.846,99",CAIXA,Despesa com pessoal,Salário,../data/raw/BANCO CAIXA - 2023.xlsx
2023-02-06,ENVIO PIX ELISABETE - PAGTO DE PRO-LABORE,61226,0.0,1335.0,"5.511,99",CAIXA,Despesa com pessoal,Pró labore,../data/raw/BANCO CAIXA - 2023.xlsx
2023-02-06,ENVIO TEV SIMONE- PAGTO DE TERCEIRO,61240,0.0,1800.0,"3.711,99",CAIXA,Despesa com serviços,Mão de obra,../data/raw/BANCO CAIXA - 2023.xlsx
2023-02-06,DB CEST PJ,12023,0.0,69.0,"3.642,99",CAIXA,Despesas financeiras,Despesas com cobrança,../data/raw/BANCO CAIXA - 2023.xlsx
2023-02-07,CRED TED - PAGSEGURO INTERNET LTDA,290,424.24,0.0,"4.067,23",CAIXA,Outras entradas,Receita não identificada,../data/raw/BANCO CAIXA - 2023.xlsx
2023-02-08,CRED TED - PAGSEGURO INTERNET LTDA,290,866.8,0.0,"4.934,03",CAIXA,Outras entradas,Receita não identificada,../data/raw/BANCO CAIXA - 2023.xlsx
2023-02-08,CRED TED - PAGSEGURO INTERNET LTDA,290,508.21,0.0,"5.442,24",CAIXA,Outras entradas,Receita não identificada,../data/raw/BANCO CAIXA - 2023.xlsx
2023-02-08,PAG BOLETO ALUGUEL,81600,0.0,4078.93,"1.363,31",CAIXA,Despesas administrativas,Aluguel imóvel,../data/raw/BANCO CAIXA - 2023.xlsx
2023-02-08,PAG BOLETO CIEE - ESTAGIÁRIOS,81603,0.0,1230.76,"132,55",CAIXA,Despesa com pessoal,CIEE (Estagiario),../data/raw/BANCO CAIXA - 2023.xlsx
2023-02-10,CRED TED PANASONIC DO BRASIL LIMITADA NFS-e 2259,341,4390.82,0.0,"4.523,37",CAIXA,Receita com serviços,Panasonic,../data/raw/BANCO CAIXA - 2023.xlsx
2023-02-15,CRED TED SPRINGER CARRIER LTDA NFS-e 2268,341,6533.41,0.0,"11.056,78",CAIXA,Receita com serviços,Spring,../data/raw/BANCO CAIXA - 2023.xlsx
2023-02-15,PAG BOLETO CARTÃO AMERICAN,151520,0.0,2006.0,"9.050,78",CAIXA,Despesas administrativas,Outras,../data/raw/BANCO CAIXA - 2023.xlsx
2023-02-16,PG ORG GOV - DARF/GPS,161458,0.0,1302.16,"7.748,62",CAIXA,Despesa com pessoal,INSS,../data/raw/BANCO CAIXA - 2023.xlsx
2023-02-17,CRED TED - PAGSEGURO INTERNET LTDA,290,1296.57,0.0,"9.045,19",CAIXA,Outras entradas,Receita não identificada,../data/raw/BANCO CAIXA - 2023.xlsx
2023-02-17,CRED TED FRESNOMAQ INDUSTRIA DE MAQUINA NFS-e 2267,341,1656.0,0.0,"10.701,19",CAIXA,Receita com serviços,Fresnomaq,../data/raw/BANCO CAIXA - 2023.xlsx
2023-02-22,PG ORG GOV - DAS,201028,0.0,2280.21,"8.420,98",CAIXA,Despesas tributárias ,Outras,../data/raw/BANCO CAIXA - 2023.xlsx
2023-03-01,CRED TED - PAGSEGURO INTERNET LTDA,290,640.17,0.0,"9.061,15",CAIXA,Receita com serviços,Outras,../data/raw/BANCO CAIXA - 2023.xlsx
2023-03-02,ENVIO PIX GUILHERME - PAGTO VT ESTAGIÁRIO,21710,0.0,264.0,"8.797,15",CAIXA,Despesa com pessoal,Transporte (VT),../data/raw/BANCO CAIXA - 2023.xlsx
2023-03-06,ENVIO TEV ROBSON - PAGTO DE SALÁRIO,61227,0.0,1982.08,"6.815,07",CAIXA,Despesa com pessoal,Salário,../data/raw/BANCO CAIXA - 2023.xlsx
2023-03-06,ENVIO PIX THIAGO - PAGTO DE SALÁRIO,61244,0.0,1520.9,"5.294,17",CAIXA,Despesa com pessoal,Salário,../data/raw/BANCO CAIXA - 2023.xlsx
2023-03-06,ENVIO PIX OSIEL - PAGTO DE SALÁRIO,61249,0.0,2644.9,"2.649,27",CAIXA,Despesa com pessoal,Salário,../data/raw/BANCO CAIXA - 2023.xlsx
2023-03-06,ENVIO PIX - HONORÁRIOS CONTABILIDADE,61327,0.0,801.0,"1.848,27",CAIXA,Despesas administrativas,Contabilidade,../data/raw/BANCO CAIXA - 2023.xlsx
2023-03-06,DB CEST PJ,22023,0.0,69.0,"1.779,27",CAIXA,Despesas financeiras,Despesas com cobrança,../data/raw/BANCO CAIXA - 2023.xlsx
2023-03-07,ENVIO PIX CLAUDIO - PAGTO PRO-LABORE,71237,0.0,1335.0,"444,27",CAIXA,Despesa com pessoal,Pró labore,../data/raw/BANCO CAIXA - 2023.xlsx
2023-03-10,CRED TED - PANASONIC DO BRASIL LIMITADA NFS-e 2274,341,9676.03,0.0,"10.120,30",CAIXA,Receita com serviços,Panasonic,../data/raw/BANCO CAIXA - 2023.xlsx
2023-03-10,PAG BOLETO WHITE MARTINS,101501,0.0,39.76,"10.080,54",CAIXA,Despesa com produtos,Materiais de Consumo,../data/raw/BANCO CAIXA - 2023.xlsx
2023-03-14,CRED TED SPRINGER CARRIER LTDA NFS-e 2277,341,11875.63,0.0,"21.956,17",CAIXA,Receita com serviços,Spring,../data/raw/BANCO CAIXA - 2023.xlsx
2023-03-14,PAG DARF-IRRF - OSIEL,412030,0.0,35.1,"21.921,07",CAIXA,Despesas tributárias ,Outras,../data/raw/BANCO CAIXA - 2023.xlsx
2023-03-14,PAG BOLETO CARTÃO AMERICAN,604385,0.0,2712.7,"19.208,37",CAIXA,Despesas administrativas,Outras,../data/raw/BANCO CAIXA - 2023.xlsx
2023-03-14,PG LUZ/GAS - ENERGIA LJ 03,941300,0.0,186.76,"19.021,61",CAIXA,Despesas administrativas,Energia,../data/raw/BANCO CAIXA - 2023.xlsx
2023-03-14,PG LUZ/GAS - ENERGIA LJ 04,942339,0.0,54.95,"18.966,66",CAIXA,Despesas administrativas,Energia,../data/raw/BANCO CAIXA - 2023.xlsx
2023-03-14,PG LUZ/GAS - ENERGIA LJ 06,942673,0.0,496.83,"18.509,83",CAIXA,Despesas administrativas,Energia,../data/raw/BANCO CAIXA - 2023.xlsx
2023-03-14,ENVIO PIX LARYSSA - DEVOLUÇÃO PARCIAL DE EMPRÉSTIMO EM 08/05/2017,142125,0.0,500.0,"18.009,83",CAIXA,Despesa com pessoal,Outras,../data/raw/BANCO CAIXA - 2023.xlsx
2023-03-20,ENVIO PIX BRENNO - PAGTO ADIANTAMENTO SALÁRIO,201218,0.0,489.63,"17.520,20",CAIXA,Despesa com pessoal,Salário,../data/raw/BANCO CAIXA - 2023.xlsx
2023-03-20,PAG BOLETO CARTÃO INTER,201303,0.0,3353.15,"14.167,05",CAIXA,Despesas administrativas,Outras,../data/raw/BANCO CAIXA - 2023.xlsx
2023-03-21,CRED PIX FRESNOMAQ INDUSTRIA DE MAQUINA NFS-e 2276,211210,1455.0,0.0,"15.622,05",CAIXA,Receita com serviços,Fresnomaq,../data/raw/BANCO CAIXA - 2023.xlsx
2023-03-23,CRED TED DAIKIN AR CONDICIONADO BRASIL NFS-e 2278,33,150.0,0.0,"15.722,05",CAIXA,Receita com serviços,Outras,../data/raw/BANCO CAIXA - 2023.xlsx
2023-03-29,PAG BOLETO VT BRENNO E ESTAGIÁRIOS: MATEUS E BIANCA,291518,0.0,650.94,"15.121,11",CAIXA,Despesa com pessoal,Transporte (VT),../data/raw/BANCO CAIXA - 2023.xlsx
2023-03-30,ENVIO PIX BARBARA - PAGTO DE RESCISÃO,301620,0.0,736.3,"14.384,81",CAIXA,Despesa com pessoal,Aviso prévio / Multa rescisória,../data/raw/BANCO CAIXA - 2023.xlsx
2023-03-31,CRED PIX HORFRAN NF-e 4180,311522,870.0,0.0,"15.254,81",CAIXA,Receita com serviços,Outras,../data/raw/BANCO CAIXA - 2023.xlsx
2023-03-31,PAG BOLETO DUFRIO,311656,0.0,307.73,"14.947,08",CAIXA,Despesa com serviços,Outras,../data/raw/BANCO CAIXA - 2023.xlsx
2023-03-31,PAG BOLETO CRT CLAUDIO,311659,0.0,324.24,"14.622,84",CAIXA,Despesa com pessoal,Outras,../data/raw/BANCO CAIXA - 2023.xlsx
2023-03-31,PAG BOLETO CRT ECEEL-TEC,311702,0.0,324.24,"14.298,60",CAIXA,Despesa com pessoal,Outras,../data/raw/BANCO CAIXA - 2023.xlsx
2023-03-31,ENVIO PIX MATHEUS LEITE - PAGTO VT ESTAGIÁRIO,311746,0.0,216.0,"14.082,60",CAIXA,Despesa com pessoal,Transporte (VT),../data/raw/BANCO CAIXA - 2023.xlsx
2023-03-31,ENVIO PIX MATHEUS ROSA - PAGTO VT ESTAGIÁRIO,311749,0.0,239.0,"13.843,60",CAIXA,Despesa com pessoal,Transporte (VT),../data/raw/BANCO CAIXA - 2023.xlsx
2023-03-31,ENVIO PIX GUILHERME - PAGTO VT ESTAGIÁRIO,311751,0.0,216.0,"13.627,60",CAIXA,Despesa com pessoal,Transporte (VT),../data/raw/BANCO CAIXA - 2023.xlsx
2023-04-05,ENVIO PIX HONORÁRIOS CONTABILIDADE,,0.0,523.0,"13.104,60",CAIXA,Despesas administrativas,Contabilidade,../data/raw/BANCO CAIXA - 2023.xlsx
2023-04-05,DB CEST PJ,,0.0,69.0,"13.035,60",CAIXA,Despesas financeiras,Despesas com cobrança,../data/raw/BANCO CAIXA - 2023.xlsx
2023-04-06,DEB P FGTS,,0.0,1123.92,"11.911,68",CAIXA,Despesa com pessoal,FGTS,../data/raw/BANCO CAIXA - 2023.xlsx
2023-04-06,PAG BOLETO ALUGUEL,,0.0,4078.93,"7.832,75",CAIXA,Despesas administrativas,Aluguel imóvel,../data/raw/BANCO CAIXA - 2023.xlsx
2023-04-06,ENVIO TEV MIRIA - PAGTO DE SALÁRIO,,0.0,1060.22,"6.772,53",CAIXA,Despesa com pessoal,Salário,../data/raw/BANCO CAIXA - 2023.xlsx
2023-04-06,ENVIO TEV ROBSON - PAGTO DE SALÁRIO,,0.0,2079.68,"4.692,85",CAIXA,Despesa com pessoal,Salário,../data/raw/BANCO CAIXA - 2023.xlsx
2023-04-06,ENVIO PIX OSIEL - PAGTO DE SALÁRIO,,0.0,1815.43,"2.877,42",CAIXA,Despesa com pessoal,Salário,../data/raw/BANCO CAIXA - 2023.xlsx
2023-04-06,ENVIO PIX THIAGO - PAGTO DE SALÁRIO,,0.0,1603.03,"1.274,39",CAIXA,Despesa com pessoal,Salário,../data/raw/BANCO CAIXA - 2023.xlsx
2023-04-10,CRED TED PANASONIC DO BRASIL LIMITADA NFS-e 2282,,9873.73,0.0,11.148.12,CAIXA,Receita com serviços,Panasonic,../data/raw/BANCO CAIXA - 2023.xlsx
2023-04-11,ENVIO PIX OSIEL - PAGTO RESCISÃO,,0.0,119.64,"11.028,48",CAIXA,Despesa com pessoal,Aviso prévio / Multa rescisória,../data/raw/BANCO CAIXA - 2023.xlsx
2023-04-13,CRED TED SPRINGER CARRIER LTDA NFS-e 2289,,16372.24,0.0,"27.400,72",CAIXA,Receita com serviços,Spring,../data/raw/BANCO CAIXA - 2023.xlsx
2023-04-14,DOC ELET HORFRAN COMERCIAL ELETRO MOVEI - NFS-e 2246,,280.0,0.0,"27.680,72",CAIXA,Receita com serviços,Outras,../data/raw/BANCO CAIXA - 2023.xlsx
2023-04-14,DOC ELET HORFRAN COMERCIAL ELETRO MOVEI - NF-e 4056,,320.0,0.0,"28.000,72",CAIXA,Receita com serviços,Outras,../data/raw/BANCO CAIXA - 2023.xlsx
2023-04-14,PAG ENERGIA LJ 3,,0.0,178.44,"27.822,28",CAIXA,Despesas administrativas,Energia,../data/raw/BANCO CAIXA - 2023.xlsx
2023-04-14,PAG ENERGIA LJ 4,,0.0,52.47,"27.769,81",CAIXA,Despesas administrativas,Energia,../data/raw/BANCO CAIXA - 2023.xlsx
2023-04-14,PAG ENERGIA LJ 6,,0.0,385.15,"27.384,66",CAIXA,Despesas administrativas,Energia,../data/raw/BANCO CAIXA - 2023.xlsx
2023-04-14,PAG BOLETO CARTÃO AMERICAN,,0.0,1638.65,"25.746,01",CAIXA,Despesas administrativas,Outras,../data/raw/BANCO CAIXA - 2023.xlsx
2023-04-14,ENVIO PIX BRENNO - VALE,,0.0,350.0,"25.396,01",CAIXA,Despesa com pessoal,Transporte (VT),../data/raw/BANCO CAIXA - 2023.xlsx
2023-04-18,PG ORG GOV - DARF/GPS,,0.0,1436.72,"23.959,29",CAIXA,Despesa com pessoal,INSS,../data/raw/BANCO CAIXA - 2023.xlsx
2023-04-18,PAG BOLETO DUFRIO,,0.0,619.53,"23.339,76",CAIXA,Despesa com serviços,Outras,../data/raw/BANCO CAIXA - 2023.xlsx
2023-04-19,PG ORG GOV - DARF ALUGUEL,,0.0,84.58,"23.255,18",CAIXA,Despesas administrativas,Aluguel imóvel,../data/raw/BANCO CAIXA - 2023.xlsx
2023-04-19,PAG BOLETO CARTÃO INTER,,0.0,3073.23,"20.181,95",CAIXA,Despesas administrativas,Outras,../data/raw/BANCO CAIXA - 2023.xlsx
2023-04-19,PAG DARF-IRRF ,,0.0,16.68,"20.165,27",CAIXA,Despesas tributárias ,Outras,../data/raw/BANCO CAIXA - 2023.xlsx
2023-04-19,PG ORG GOV DAS,,0.0,2553.58,"17.611,69",CAIXA,Despesas tributárias ,Outras,../data/raw/BANCO CAIXA - 2023.xlsx
2023-04-20,CRED TED BHG S A BRAZIL HOSPITALITY GRO - NFS-e 2291,,430.0,0.0,"18.041,69",CAIXA,Receita com serviços,Outras,../data/raw/BANCO CAIXA - 2023.xlsx
2023-04-20,CRED TED BHG S A BRAZIL HOSPITALITY GRO - NF-e 4231,,295.0,0.0,"18.336,69",CAIXA,Receita com serviços,Outras,../data/raw/BANCO CAIXA - 2023.xlsx
2023-04-20,ENVIO PIX BRENNO - ADIANTAMENTO DE SALÁRIO,,0.0,696.04,"17.640,65",CAIXA,Despesa com pessoal,Salário,../data/raw/BANCO CAIXA - 2023.xlsx
2023-04-24,CRED TED FRESNOMAQ INDUSTRIA DE MAQUINA NFS-e 2288,,2395.0,0.0,"20.035,65",CAIXA,Receita com serviços,Fresnomaq,../data/raw/BANCO CAIXA - 2023.xlsx
2023-04-25,PAG BOLETO MEDCURITIBA,,0.0,147.62,"19.888,03",CAIXA,Despesa com pessoal,Assistência médica,../data/raw/BANCO CAIXA - 2023.xlsx
2023-04-25,PAG FONE - LIGGA TELECOM,,0.0,149.9,"19.738,13",CAIXA,Despesas administrativas,"Telefonia (Celular, Fixo, Internet)",../data/raw/BANCO CAIXA - 2023.xlsx
2023-04-25,PAG FONE - NET FONE,,0.0,123.6,"19.614,53",CAIXA,Despesas administrativas,"Telefonia (Celular, Fixo, Internet)",../data/raw/BANCO CAIXA - 2023.xlsx
2023-04-25,PAG FONE CELULAR,,0.0,57.61,"19.556,92",CAIXA,Despesas administrativas,"Telefonia (Celular, Fixo, Internet)",../data/raw/BANCO CAIXA - 2023.xlsx
2023-04-27,PAG BOLETO VT BRENNO,,0.0,266.94,"19.289,98",CAIXA,Despesa com pessoal,Transporte (VT),../data/raw/BANCO CAIXA - 2023.xlsx
2023-04-27,PAG BOLETO SPRINGER CARRIER,,0.0,654.26,"18.635,72",CAIXA,Despesa com serviços,Spring,../data/raw/BANCO CAIXA - 2023.xlsx
2023-04-27,PAG BOLETO MASTER FILME EMBALAGENS,,0.0,850.1,"17.785,62",CAIXA,Despesa com produtos,Materiais de Consumo,../data/raw/BANCO CAIXA - 2023.xlsx
2023-04-27,ENVIO PIX MATHEUS LEITE - VT ESTAGIÁRIO,,0.0,264.0,"17.521,62",CAIXA,Despesa com pessoal,Transporte (VT),../data/raw/BANCO CAIXA - 2023.xlsx
2023-04-28,ENVIO PIX MATHEUS ROSA - VT ESTAGIÁRIO,,0.0,264.0,"17.257,62",CAIXA,Despesa com pessoal,Transporte (VT),../data/raw/BANCO CAIXA - 2023.xlsx
2023-04-28,ENVIO PIX GUILHERME - VT ESTAGIÁRIO,,0.0,252.0,"17.005,62",CAIXA,Despesa com pessoal,Transporte (VT),../data/raw/BANCO CAIXA - 2023.xlsx
2023-04-28,PAG BOLETO VALE REFEIÇÃO,,0.0,1200.0,"15.805,62",CAIXA,Despesa com pessoal,Alimentação (VR VA),../data/raw/BANCO CAIXA - 2023.xlsx
2023-05-02,CRED PIX HORFRAN - COMERCIAL ELETRO MOV - NF-e 4252 E NFS-e 2296,21600,455.0,0.0,"16.260,62",CAIXA,Receita com serviços,Outras,../data/raw/BANCO CAIXA - 2023.xlsx
2023-05-02,PAG BOLETO REFRIGERAÇÃO DUFRIO,401627,0.0,619.52,"15.641,10",CAIXA,Despesa com serviços,Outras,../data/raw/BANCO CAIXA - 2023.xlsx
2023-05-04,ENVIO PIX HONORÁRIOS CONTABILIDADE,41552,0.0,523.0,"15.118,10",CAIXA,Despesas administrativas,Contabilidade,../data/raw/BANCO CAIXA - 2023.xlsx
2023-05-05,ENVIO TEV MIRIA - PAGTO DE SALÁRIO,51133,0.0,1645.4,"13.472,70",CAIXA,Despesa com pessoal,Salário,../data/raw/BANCO CAIXA - 2023.xlsx
2023-05-05,ENVIO TEV ROBSON - PAGTO DE SALÁRIO,51137,0.0,2036.2,"11.436,50",CAIXA,Despesa com pessoal,Salário,../data/raw/BANCO CAIXA - 2023.xlsx
2023-05-05,ENVIO PIX BRENNO -  PAGTO DE SALÁRIO,51142,0.0,594.37,"10.842,13",CAIXA,Despesa com pessoal,Salário,../data/raw/BANCO CAIXA - 2023.xlsx
2023-05-05,ENVIO PIX THIAGO -  PAGTO DE SALÁRIO,51148,0.0,1603.03,"9.239,10",CAIXA,Despesa com pessoal,Salário,../data/raw/BANCO CAIXA - 2023.xlsx
2023-05-05,ENVIO PIX ELIZABETE - PRO-LABORE,51151,0.0,1335.0,"7.904,10",CAIXA,Despesa com pessoal,Pró labore,../data/raw/BANCO CAIXA - 2023.xlsx
2023-05-05,ENVIO PIX CLAUDIO - PRO-LABORE,51154,0.0,1335.0,"6.569,10",CAIXA,Despesa com pessoal,Pró labore,../data/raw/BANCO CAIXA - 2023.xlsx
2023-05-05,PAG FGTS,51159,0.0,992.95,"5.576,15",CAIXA,Despesa com pessoal,FGTS,../data/raw/BANCO CAIXA - 2023.xlsx
2023-05-05,DB CEST PJ,42023,0.0,69.0,"5.507,15",CAIXA,Despesas financeiras,Despesas com cobrança,../data/raw/BANCO CAIXA - 2023.xlsx
2023-05-08,PAG BOLETO ALUGUEL,81222,0.0,4707.97,"799,18",CAIXA,Despesas administrativas,Aluguel imóvel,../data/raw/BANCO CAIXA - 2023.xlsx
2023-05-09,CRED TED BRASANITAS HOSPITALAR HIGIEN - NF-e 4230 E NFS-e 2290,237,785.0,0.0,"1.584,18",CAIXA,Receita com serviços,Outras,../data/raw/BANCO CAIXA - 2023.xlsx
2023-05-10,CRED TED PANASONIC DO BRASIL LIMITADA - NFS-e 2295,341,6468.36,0.0,"8.052,54",CAIXA,Receita com serviços,Panasonic,../data/raw/BANCO CAIXA - 2023.xlsx
2023-05-15,CRED TED DAIKIN AR CONDICIONADO BRASIL NFS-e 2303,33,150.0,0.0,"8.202,54",CAIXA,Receita com serviços,Outras,../data/raw/BANCO CAIXA - 2023.xlsx
2023-05-15,PAG BOLETO CARTÃO AMERICAN,,0.0,3872.31,"4.330,23",CAIXA,Despesas administrativas,Outras,../data/raw/BANCO CAIXA - 2023.xlsx
2023-05-19,PG ORG GOV DARF/GPS,191108,0.0,1194.57,"3.135,66",CAIXA,Despesa com pessoal,INSS,../data/raw/BANCO CAIXA - 2023.xlsx
2023-05-19,PG ORG GOV DARF - I.R.R.F. REF. AO ALUGUEL ,191110,0.0,84.58,"3.051,08",CAIXA,Despesas administrativas,Aluguel imóvel,../data/raw/BANCO CAIXA - 2023.xlsx
2023-05-19,PAG DARF-IRRF ,191118,0.0,10.72,"3.040,36",CAIXA,Despesas tributárias ,Outras,../data/raw/BANCO CAIXA - 2023.xlsx
2023-05-19,CRED TED SPRINGER CARRIER LTDA NFS-e 2301,341,11602.19,0.0,"14.642,55",CAIXA,Receita com serviços,Spring,../data/raw/BANCO CAIXA - 2023.xlsx
2023-05-22,CRED TED FRESNOMAQ INDUSTRIA DE MAQUINA NFS-e 2302,341,2185.0,0.0,"16.827,55",CAIXA,Receita com serviços,Fresnomaq,../data/raw/BANCO CAIXA - 2023.xlsx
2023-05-23,PAG BOLETO SELETROAR - PARCELA 1 DE 5,231241,0.0,92.79,"16.734,76",CAIXA,Despesa com serviços,Outras,../data/raw/BANCO CAIXA - 2023.xlsx
2023-05-29,PAG BOLETO - VALE TRANSPORTE BRENNO,292007,0.0,242.94,"16.491,82",CAIXA,Despesa com pessoal,Transporte (VT),../data/raw/BANCO CAIXA - 2023.xlsx
2023-06-05,CRED TED BRASANITAS HOSPITALAR HIGIEN - NFS-e 2305 E NF-e 4267,237,630.0,0.0,"17.121,82",CAIXA,Receita com serviços,Outras,../data/raw/BANCO CAIXA - 2023.xlsx
2023-06-05,DB CEST PJ,52023,0.0,69.0,"17.052,82",CAIXA,Despesas financeiras,Despesas com cobrança,../data/raw/BANCO CAIXA - 2023.xlsx
2023-06-06,CRED TED CLEUNICE B MESSIAS,1,200.0,0.0,"17.252,82",CAIXA,Receita com serviços,Outras,../data/raw/BANCO CAIXA - 2023.xlsx
2023-06-06,ENVIO TEV MIRIA - PAGTO DE SALÁRIO,61138,0.0,1617.4,"15.635,42",CAIXA,Despesa com pessoal,Salário,../data/raw/BANCO CAIXA - 2023.xlsx
2023-06-06,ENVIO TEV ROBSON - PAGTO DE SALÁRIO,61143,0.0,1957.64,"13.677,78",CAIXA,Despesa com pessoal,Salário,../data/raw/BANCO CAIXA - 2023.xlsx
2023-06-06,PAG FGTS,61154,0.0,896.48,"12.781,30",CAIXA,Despesa com pessoal,FGTS,../data/raw/BANCO CAIXA - 2023.xlsx
2023-06-06,ENVIO PIX HONORÁRIOS CONTABILIDADE,61538,0.0,523.0,"12.258,30",CAIXA,Despesas administrativas,Contabilidade,../data/raw/BANCO CAIXA - 2023.xlsx
2023-06-07,PAG BOLETO - ALUGUEL,71521,0.0,4707.97,"7.550,33",CAIXA,Despesas administrativas,Aluguel imóvel,../data/raw/BANCO CAIXA - 2023.xlsx
2023-06-09,PAG BOLETO CIEE - ESTAGIÁRIOS,91720,0.0,1100.57,"6.449,76",CAIXA,Despesa com pessoal,CIEE (Estagiario),../data/raw/BANCO CAIXA - 2023.xlsx
2023-06-12,CRED TED PANASONIC DO BRASIL LIMITADA NFS-e 2308,341,5314.62,0.0,"11.764,38",CAIXA,Receita com serviços,Panasonic,../data/raw/BANCO CAIXA - 2023.xlsx
2023-06-13,CRED TED SPRINGER CARRIER LTDA NFS-e 2320,341,6841.55,0.0,"18.605,93",CAIXA,Receita com serviços,Spring,../data/raw/BANCO CAIXA - 2023.xlsx
2023-06-16,PAG BOLETO SPRINGER CARRIER,161524,0.0,712.29,"17.893,64",CAIXA,Despesa com serviços,Spring,../data/raw/BANCO CAIXA - 2023.xlsx
2023-06-19,ENVIO TEV MIRIA DO ROCIO CALONACI- PAGTO DE RESCISÃO,190952,0.0,1540.64,"16.353,00",CAIXA,Despesa com pessoal,Aviso prévio / Multa rescisória,../data/raw/BANCO CAIXA - 2023.xlsx
2023-06-19,PAG BOLETO - SOLUÇÃO CERTIFICADO DIGITAL,191524,0.0,175.0,"16.178,00",CAIXA,Despesas administrativas,Outras,../data/raw/BANCO CAIXA - 2023.xlsx
2023-06-19,PG ORG GOV - DARF/GPS ,191529,0.0,1219.71,"14.958,29",CAIXA,Despesa com pessoal,INSS,../data/raw/BANCO CAIXA - 2023.xlsx
2023-06-19,PG ORG GOV - DARF ALUGUEL,191531,0.0,84.58,"14.873,71",CAIXA,Despesas administrativas,Aluguel imóvel,../data/raw/BANCO CAIXA - 2023.xlsx
2023-06-19,PG ORG GOV - DAS,191534,0.0,2690.29,"12.183,42",CAIXA,Despesas tributárias ,Outras,../data/raw/BANCO CAIXA - 2023.xlsx
2023-06-21,CRED TED FRESNOMAQ INDUSTRIA DE MAQUINA NFS-e 2319,341,5717.5,0.0,"17.900,92",CAIXA,Receita com serviços,Fresnomaq,../data/raw/BANCO CAIXA - 2023.xlsx
2023-06-23,PAG FONE NET FONE,231409,0.0,123.6,"17.777,32",CAIXA,Despesas administrativas,"Telefonia (Celular, Fixo, Internet)",../data/raw/BANCO CAIXA - 2023.xlsx
2023-06-23,PAG FONE CELULAR,231413,0.0,57.61,"17.719,71",CAIXA,Despesas administrativas,"Telefonia (Celular, Fixo, Internet)",../data/raw/BANCO CAIXA - 2023.xlsx
2023-06-23,PAG FONE LIGGA TELECOM,231416,0.0,149.9,"17.569,81",CAIXA,Despesas administrativas,"Telefonia (Celular, Fixo, Internet)",../data/raw/BANCO CAIXA - 2023.xlsx
2023-06-23,PAG BOLETO MED CURITIBA,231419,0.0,115.99,"17.453,82",CAIXA,Despesa com pessoal,Assistência médica,../data/raw/BANCO CAIXA - 2023.xlsx
2023-06-23,PAG BOLETO SPRINGER CARRIER - 2/3,231422,0.0,492.34,"16.961,48",CAIXA,Despesa com serviços,Spring,../data/raw/BANCO CAIXA - 2023.xlsx
2023-06-23,PAG BOLETO FRESNOMAQ-WAP,231426,0.0,138.22,"16.823,26",CAIXA,Despesa com serviços,Fresnomaq,../data/raw/BANCO CAIXA - 2023.xlsx
2023-06-23,PAG BOLETO SPRINGER CARRIER - 4/4,231429,0.0,654.24,"16.169,02",CAIXA,Despesa com serviços,Spring,../data/raw/BANCO CAIXA - 2023.xlsx
2023-06-23,PAG BOLETO WHITE MARTINS,231432,0.0,327.41,"15.841,61",CAIXA,Despesa com produtos,Materiais de Consumo,../data/raw/BANCO CAIXA - 2023.xlsx
2023-06-26,CRED TED DAIKIN AR CONDICIONADO BRASIL NFS-e 2321,33,370.0,0.0,"16.211,61",CAIXA,Receita com serviços,Outras,../data/raw/BANCO CAIXA - 2023.xlsx
2023-06-28,PAG BOLETO - VALE TRANSPORTE DA CINTHYA,281202,0.0,254.94,"15.956,67",CAIXA,Despesa com pessoal,Transporte (VT),../data/raw/BANCO CAIXA - 2023.xlsx
2023-06-28,PAG BOLETO - CRT-CONSELHO REGIONAL DOS TECNICOS - 2/6 PARC.,281209,0.0,193.14,"15.763,53",CAIXA,Despesa com pessoal,Outras,../data/raw/BANCO CAIXA - 2023.xlsx
2023-06-30,CRED PIX HORFRAN - COMERCIAL ELETRO MOVEIS LTDA-NFS-e 2324,301538,200.0,0.0,"15.963,53",CAIXA,Receita com serviços,Outras,../data/raw/BANCO CAIXA - 2023.xlsx
2023-06-30,PAG BOLETO - VR BENEFÍCIOS,301122,0.0,1050.0,"14.913,53",CAIXA,Despesa com pessoal,Alimentação (VR VA),../data/raw/BANCO CAIXA - 2023.xlsx
2023-07-04,DP DIN LOT CLIENTE,41731,290.0,0.0,"15.203,53",CAIXA,Receita com serviços,Outras,../data/raw/BANCO CAIXA - 2023.xlsx
2023-07-05,DB CEST PJ,62023,0.0,69.0,"15.134,53",CAIXA,Despesas financeiras,Despesas com cobrança,../data/raw/BANCO CAIXA - 2023.xlsx
2023-07-06,DEB P FGTS,575861,0.0,917.24,"14.217,29",CAIXA,Despesa com pessoal,FGTS,../data/raw/BANCO CAIXA - 2023.xlsx
2023-07-06,ENVIO TEV ROBSON FERNANDES - PAGTO DE SALÁRIO,61208,0.0,2277.04,"11.940,25",CAIXA,Despesa com pessoal,Salário,../data/raw/BANCO CAIXA - 2023.xlsx
2023-07-06,ENVIO PIX CINTHYA BAUCH SANTIAGO,61216,0.0,1558.72,"10.381,53",CAIXA,Despesa com pessoal,Salário,../data/raw/BANCO CAIXA - 2023.xlsx
2023-07-06,ENVIO PIX THIAGO IANUCH MARIN,61222,0.0,1603.3,"8.778,23",CAIXA,Despesa com pessoal,Salário,../data/raw/BANCO CAIXA - 2023.xlsx
2023-07-06,ENVIO PIX CONTABILIDADE -PAGTO HONORARIO ,61226,0.0,523.0,"8.255,23",CAIXA,Despesas administrativas,Contabilidade,../data/raw/BANCO CAIXA - 2023.xlsx
2023-07-07,PAG BOLETO WHITE MARTINS,71553,0.0,39.76,"8.215,47",CAIXA,Despesa com produtos,Materiais de Consumo,../data/raw/BANCO CAIXA - 2023.xlsx
2023-07-07,PAG BOLETO ALUGUEL,71556,0.0,4707.97,"3.507,50",CAIXA,Despesas administrativas,Aluguel imóvel,../data/raw/BANCO CAIXA - 2023.xlsx
2023-07-07,PAG BOLETO CIEE - ESTAGIÁRIOS,71603,0.0,1000.38,"2.507,12",CAIXA,Despesa com pessoal,CIEE (Estagiario),../data/raw/BANCO CAIXA - 2023.xlsx
2023-07-10,CRED TED PANASONIC DO BRASIL LIMITADA NFS-e 2325,341,9377.79,0.0,"11.884,91",CAIXA,Receita com serviços,Panasonic,../data/raw/BANCO CAIXA - 2023.xlsx
2023-07-13,CRED TED SPRINGER CARRIER LTDA NFS-e 2334,341,2350.54,0.0,"14.235,45",CAIXA,Receita com serviços,Spring,../data/raw/BANCO CAIXA - 2023.xlsx
2023-07-14,PAG BOLETO CARTÃO AMERICAN,141201,0.0,1665.48,"12.569,97",CAIXA,Despesas administrativas,Outras,../data/raw/BANCO CAIXA - 2023.xlsx
2023-07-18,CRED PIX HORFRAN NFS-e 2331 E NF-e 4335,180925,290.0,0.0,"12.859,97",CAIXA,Receita com serviços,Outras,../data/raw/BANCO CAIXA - 2023.xlsx
2023-07-19,PG ORG GOV - DAS,191543,0.0,2750.96,"10.109,01",CAIXA,Despesas tributárias ,Outras,../data/raw/BANCO CAIXA - 2023.xlsx
2023-07-19,PG ORG GOV - DARF ALUGUEL,191546,0.0,84.58,"10.024,43",CAIXA,Despesas administrativas,Aluguel imóvel,../data/raw/BANCO CAIXA - 2023.xlsx
2023-07-19,PG ORG GOV - DARF/GPS,191549,0.0,1174.3,"8.850,13",CAIXA,Despesa com pessoal,INSS,../data/raw/BANCO CAIXA - 2023.xlsx
2023-07-21,CRED TED FRESNOMAQ INDUSTRIA DE MAQUINA NFS-e 2332,341,5666.4,0.0,"14.516,53",CAIXA,Receita com serviços,Fresnomaq,../data/raw/BANCO CAIXA - 2023.xlsx
2023-07-24,PAG FONE LIGGA TELECOM,241620,0.0,149.9,"14.366,63",CAIXA,Despesas administrativas,"Telefonia (Celular, Fixo, Internet)",../data/raw/BANCO CAIXA - 2023.xlsx
2023-07-24,PAG FONE NET FONE,241623,0.0,123.6,"14.243,03",CAIXA,Despesas administrativas,"Telefonia (Celular, Fixo, Internet)",../data/raw/BANCO CAIXA - 2023.xlsx
2023-07-24,PAG FONE CELULAR,241625,0.0,64.54,"14.178,49",CAIXA,Despesas administrativas,"Telefonia (Celular, Fixo, Internet)",../data/raw/BANCO CAIXA - 2023.xlsx
2023-07-24,PAG BOLETO SPRINGER CARRIER,241629,0.0,492.34,"13.686,15",CAIXA,Despesa com serviços,Spring,../data/raw/BANCO CAIXA - 2023.xlsx
2023-07-24,PAG BOLETO MED CURITIBA,241633,0.0,105.45,"13.580,70",CAIXA,Despesa com pessoal,Assistência médica,../data/raw/BANCO CAIXA - 2023.xlsx
2023-07-31,CRED TED BRASANITAS HOSPITALAR HIGIEN - NFS-e 2329-2330 E NF-e 4333,237,650.0,0.0,"14.230,70",CAIXA,Receita com serviços,Outras,../data/raw/BANCO CAIXA - 2023.xlsx
2023-08-03,CRED TED DAIKIN AR CONDICIONADO BRASIL NFS-e 2333,33,440.0,0.0,"14.670,70",CAIXA,Receita com serviços,Outras,../data/raw/BANCO CAIXA - 2023.xlsx
2023-08-04,DEB P FGTS,591245,0.0,679.02,"13.991,68",CAIXA,Despesa com pessoal,FGTS,../data/raw/BANCO CAIXA - 2023.xlsx
2023-08-04,DEB P FGTS - RESCISÃO GABRIEL,599493,0.0,731.63,"13.260,05",CAIXA,Despesa com pessoal,FGTS,../data/raw/BANCO CAIXA - 2023.xlsx
2023-08-04,PAG BOLETO ALUGUEL,641376,0.0,4707.97,"8.552,08",CAIXA,Despesas administrativas,Aluguel imóvel,../data/raw/BANCO CAIXA - 2023.xlsx
2023-08-04,ENVIO TEV ROBSON - PAGTO DE SALÁRIO,41132,0.0,2402.08,"6.150,00",CAIXA,Despesa com pessoal,Salário,../data/raw/BANCO CAIXA - 2023.xlsx
2023-08-04,ENVIO PIX CINTHYA - PAGTO DE SALÁRIO,41139,0.0,1558.72,"4.591,28",CAIXA,Despesa com pessoal,Salário,../data/raw/BANCO CAIXA - 2023.xlsx
2023-08-04,ENVIO PIX THIAGO - PAGTO DE SALÁRIO,41147,0.0,1603.3,"2.987,98",CAIXA,Despesa com pessoal,Salário,../data/raw/BANCO CAIXA - 2023.xlsx
2023-08-04,ENVIO PIX ELISABETE - PAGTO PRO-LABORE,41149,0.0,1335.0,"1.652,98",CAIXA,Despesa com pessoal,Pró labore,../data/raw/BANCO CAIXA - 2023.xlsx
2023-08-07,DB CEST PJ,72023,0.0,69.0,"1.583,98",CAIXA,Despesas financeiras,Despesas com cobrança,../data/raw/BANCO CAIXA - 2023.xlsx
2023-08-10,CRED TED PANASONIC DO BRASIL LIMITADA NF-e 2340,341,4920.88,0.0,"6.504,86",CAIXA,Receita com serviços,Panasonic,../data/raw/BANCO CAIXA - 2023.xlsx
2023-08-18,PG ORG GOV DARF REFERENTE ALUGUEL,181150,0.0,84.58,"6.420,28",CAIXA,Despesas administrativas,Aluguel imóvel,../data/raw/BANCO CAIXA - 2023.xlsx
2023-08-18,PG ORG GOV DAS ,181154,0.0,1924.85,"4.495,43",CAIXA,Despesas tributárias ,Outras,../data/raw/BANCO CAIXA - 2023.xlsx
2023-08-21,CRED PIX HORFRAN - COMERCIAL ELETRO MOVEIS LTDA - NF-e 4348,211314,150.0,0.0,"4.645,43",CAIXA,Receita com serviços,Outras,../data/raw/BANCO CAIXA - 2023.xlsx
2023-08-21,CRED TED SPRINGER CARRIER LTDA NFS-e 2344,341,6681.42,0.0,"11.326,85",CAIXA,Receita com serviços,Spring,../data/raw/BANCO CAIXA - 2023.xlsx
2023-09-05,DB CEST PJ,82023,0.0,69.0,"11.257,85",CAIXA,Despesas financeiras,Despesas com cobrança,../data/raw/BANCO CAIXA - 2023.xlsx
2023-09-06,PAG FGTS,61025,0.0,946.43,"10.311,42",CAIXA,Despesa com pessoal,FGTS,../data/raw/BANCO CAIXA - 2023.xlsx
2023-09-06,ENVIO TEV ROBSON - PAGTO DE SALÁRIO,61036,0.0,2179.71,"8.131,71",CAIXA,Despesa com pessoal,Salário,../data/raw/BANCO CAIXA - 2023.xlsx
2023-09-06,ENVIO PIX BRENDA - PAGTO DE SALÁRIO,61043,0.0,712.14,"7.419,57",CAIXA,Despesa com pessoal,Salário,../data/raw/BANCO CAIXA - 2023.xlsx
2023-09-06,ENVIO PIX CINTHYA - PAGTO DE SALÁRIO,61046,0.0,1528.72,"5.890,85",CAIXA,Despesa com pessoal,Salário,../data/raw/BANCO CAIXA - 2023.xlsx
2023-09-06,ENVIO PIX LUIZ GUILHERME - PAGTO DE SALÁRIO,61049,0.0,1134.62,"4.756,23",CAIXA,Despesa com pessoal,Salário,../data/raw/BANCO CAIXA - 2023.xlsx
2023-09-11,CRED TED PANASONIC DO BRASIL LIMITADA NFS-e 2354,341,6325.49,0.0,"11.081,72",CAIXA,Receita com serviços,Panasonic,../data/raw/BANCO CAIXA - 2023.xlsx
2023-09-12,"DEP.DINH. VENDA DA MOTO XRE300 (+ 1.000,00 NO BANCO INTER)",0,14000.0,0.0,"25.081,72",CAIXA,Despesa com serviços,Outras,../data/raw/BANCO CAIXA - 2023.xlsx
2023-09-12,CRED TED SPRINGER CARRIER LTDA NFS-e 2353,341,683.63,0.0,"25.765,35",CAIXA,Receita com serviços,Spring,../data/raw/BANCO CAIXA - 2023.xlsx
2023-09-14,CRED TED BRASANITAS EMPRESA BRASILEIRA NFS-e 2355 e NF-e 4357,237,1456.0,0.0,"27.221,35",CAIXA,Despesa com serviços,Outras,../data/raw/BANCO CAIXA - 2023.xlsx
2023-09-15,ENVIO PIX JULIANO AMORIM - COMPRA CARRO FIESTA,151418,0.0,400.0,"26.821,35",CAIXA,Despesas administrativas,Veiculos,../data/raw/BANCO CAIXA - 2023.xlsx
2023-09-15,ENVIO PIX MARIA PAULA FRATTI - COMPRA CARRO FIESTA,151515,0.0,38.22,"26.783,13",CAIXA,Despesas administrativas,Veiculos,../data/raw/BANCO CAIXA - 2023.xlsx
2023-09-15,ENVIO PIX BANCO VOTORANTIM S.A. - COMPRA CARRO FIESTA,151558,0.0,12400.02,"14.383,11",CAIXA,Despesas administrativas,Veiculos,../data/raw/BANCO CAIXA - 2023.xlsx
2023-09-15,ENVIO PIX DAVID WEBER SCHMOLLER - COMPRA CARRO FIESTA,151603,0.0,4161.98,"10.221,13",CAIXA,Despesas administrativas,Veiculos,../data/raw/BANCO CAIXA - 2023.xlsx
2023-09-19,CRED TED SPRINGER CARRIER LTDA NFS-e 2357,341,6680.08,0.0,"16.901,21",CAIXA,Receita com serviços,Spring,../data/raw/BANCO CAIXA - 2023.xlsx
2023-09-20,PG ORG GOV DARF ALUGUEL,201154,0.0,84.58,"16.816,63",CAIXA,Despesas administrativas,Aluguel imóvel,../data/raw/BANCO CAIXA - 2023.xlsx
2023-09-20,PG ORG GOV DARF/GPS,201201,0.0,1168.24,"15.648,39",CAIXA,Despesa com pessoal,INSS,../data/raw/BANCO CAIXA - 2023.xlsx
2023-09-20,PG ORG GOV DAS,201204,0.0,2080.74,"13.567,65",CAIXA,Despesas tributárias ,Outras,../data/raw/BANCO CAIXA - 2023.xlsx
2023-09-20,ENVIO PIX BRENDA - ADIANTAMENTO DE SALÁRIO,201210,0.0,696.04,"12.871,61",CAIXA,Despesa com pessoal,Salário,../data/raw/BANCO CAIXA - 2023.xlsx
2023-09-20,ENVIO PIX LUIZ GUILHERME - ADIANTAMENTO DE SALÁRIO,201214,0.0,800.0,"12.071,61",CAIXA,Despesa com pessoal,Salário,../data/raw/BANCO CAIXA - 2023.xlsx
2023-09-21,CRED TED FRESNOMAQ INDUSTRIA DE MAQUINA - NFS-e 2359,341,4845.0,0.0,"16.916,61",CAIXA,Receita com serviços,Fresnomaq,../data/raw/BANCO CAIXA - 2023.xlsx
2023-09-21,CRED TED LOJAS COLOMBO S A COM UTIL DOM - NF-e 4370,422,850.0,0.0,"17.766,61",CAIXA,Despesa com serviços,Outras,../data/raw/BANCO CAIXA - 2023.xlsx
2023-09-27,PAG BOLETO VT CINTHYA E BRENDA,271600,0.0,483.03,"17.283,58",CAIXA,Despesa com pessoal,Transporte (VT),../data/raw/BANCO CAIXA - 2023.xlsx
2023-09-27,PAG BOLETO TAXA JUNTA COMERCIAL - LIVRO,271603,0.0,42.6,"17.240,98",CAIXA,Despesas administrativas,Cartório,../data/raw/BANCO CAIXA - 2023.xlsx
2023-09-29,PAG BOLETO CRT CONSELHO REGIONAL DOS TÉCNICOS - PARC. 5/6,291053,0.0,193.14,"17.047,84",CAIXA,Despesa com pessoal,Outras,../data/raw/BANCO CAIXA - 2023.xlsx
2023-09-29,PAG BOLETO VR BENEFÍCIOS,291055,0.0,1800.0,"15.247,84",CAIXA,Despesa com pessoal,Alimentação (VR VA),../data/raw/BANCO CAIXA - 2023.xlsx
2023-09-29,ENVIO PIX MATHEUS - VT ESTAGIÁRIO,291059,0.0,240.0,"15.007,84",CAIXA,Despesa com pessoal,Transporte (VT),../data/raw/BANCO CAIXA - 2023.xlsx
2023-09-29,ENVIO PIX MATHEUS - SERVIÇOS PRESTADOS,291101,0.0,260.0,"14.747,84",CAIXA,Despesa com serviços,Mão de obra,../data/raw/BANCO CAIXA - 2023.xlsx
2023-09-29,ENVIO PIX LUIZ - ALIMENTAÇÃO HORAS EXTRAS,291108,0.0,15.0,"14.732,84",CAIXA,Despesa com pessoal,Alimentação (VR VA),../data/raw/BANCO CAIXA - 2023.xlsx
2023-09-29,ENVIO PIX LUIZ ,291110,0.0,200.0,"14.532,84",CAIXA,Despesa com pessoal,Outras,../data/raw/BANCO CAIXA - 2023.xlsx
2023-09-29,ENVIO PIX RENAN - VT ESTAGIÁRIO,291645,0.0,240.0,"14.292,84",CAIXA,Despesa com pessoal,Transporte (VT),../data/raw/BANCO CAIXA - 2023.xlsx
2023-10-03,ENVIO PIX -VISAO TOTAL VISTORIA VEICULAR CURITIBA - NFS-e 144,31310,0.0,250.0,"14.042,84",CAIXA,Despesas administrativas,Veiculos,../data/raw/BANCO CAIXA - 2023.xlsx
2023-10-05,ENVIO PIX LARYSSA - PRESTAÇÃO DE SERVIÇOS,51122,0.0,1800.0,"12.242,84",CAIXA,Despesa com serviços,Mão de obra,../data/raw/BANCO CAIXA - 2023.xlsx
2023-10-05,ENVIO PIX CONTABILIDADE - HONORÁRIOS,51128,0.0,523.0,"11.719,84",CAIXA,Despesas administrativas,Contabilidade,../data/raw/BANCO CAIXA - 2023.xlsx
2023-10-05,DB CEST PJ,92023,0.0,69.0,"11.650,84",CAIXA,Despesas financeiras,Despesas com cobrança,../data/raw/BANCO CAIXA - 2023.xlsx
2023-10-06,ENVIO TEV ROBSON - PAGAMENTO DE SALÁRIO,61123,0.0,2083.41,"9.567,43",CAIXA,Despesa com pessoal,Salário,../data/raw/BANCO CAIXA - 2023.xlsx
2023-10-06,ENVIO PIX BRENDA - PAGAMENTO DE SALÁRIO,61132,0.0,835.64,"8.731,79",CAIXA,Despesa com pessoal,Salário,../data/raw/BANCO CAIXA - 2023.xlsx
2023-10-06,ENVIO PIX LUIZ GUILHERME - PAGAMENTO DE SALÁRIO,61135,0.0,1392.28,"7.339,51",CAIXA,Despesa com pessoal,Salário,../data/raw/BANCO CAIXA - 2023.xlsx
2023-10-06,ENVIO PIX ELISABETE PRÓ-LABORE,61140,0.0,1335.0,"6.004,51",CAIXA,Despesa com pessoal,Pró labore,../data/raw/BANCO CAIXA - 2023.xlsx
2023-10-06,ENVIO PIX CLAUDIO PRÓ-LABORE,61142,0.0,1335.0,"4.669,51",CAIXA,Despesa com pessoal,Pró labore,../data/raw/BANCO CAIXA - 2023.xlsx
2023-10-09,CRED TED DAIKIN AR CONDICIONADO BRASIL NFS-e 2358,33,300.0,0.0,"4.969,51",CAIXA,Despesa com serviços,Outras,../data/raw/BANCO CAIXA - 2023.xlsx
2023-10-09,PAG BOLETO CIEE - ESTAGIÁRIOS,91503,0.0,955.38,"4.014,13",CAIXA,Despesa com pessoal,CIEE (Estagiario),../data/raw/BANCO CAIXA - 2023.xlsx
2023-10-09,PAG BOLETO WHITE MARTINS,91507,0.0,39.76,"3.974,37",CAIXA,Despesa com produtos,Materiais de Consumo,../data/raw/BANCO CAIXA - 2023.xlsx
2023-10-10,CRED TED PANASONIC DO BRASIL LIMITADA NFS-e 2364,341,2172.2,0.0,"6.146,57",CAIXA,Receita com serviços,Panasonic,../data/raw/BANCO CAIXA - 2023.xlsx
2023-10-16,CRED PIX HORFRAN - COMERCIAL ELETRO MOVEIS LTDA - NFS-e 2369,161651,180.0,0.0,"6.326,57",CAIXA,Receita com serviços,Outras,../data/raw/BANCO CAIXA - 2023.xlsx
2023-10-16,CRED PIX HORFRAN - COMERCIAL ELETRO MOVEIS LTDA - NF-e 4388,161651,720.0,0.0,"7.046,57",CAIXA,Receita com serviços,Outras,../data/raw/BANCO CAIXA - 2023.xlsx
2023-10-16,PAG BOLETO PARANÁ CLINICAS-CONVÊNIO MÉDICO,434554,0.0,955.44,"6.091,13",CAIXA,Despesa com pessoal,Assistência médica,../data/raw/BANCO CAIXA - 2023.xlsx
2023-10-16,PAG BOLETO FRESNOMAQ-WAP,438849,0.0,325.62,"5.765,51",CAIXA,Despesa com serviços,Fresnomaq,../data/raw/BANCO CAIXA - 2023.xlsx
2023-10-20,PG ORG GOV DARF/GPS,201150,0.0,1192.48,"4.573,03",CAIXA,Despesa com pessoal,INSS,../data/raw/BANCO CAIXA - 2023.xlsx
2023-10-20,PG ORG GOV DARF/ALUGUEL DO IMÓVEL,201154,0.0,84.58,"4.488,45",CAIXA,Despesas administrativas,Aluguel imóvel,../data/raw/BANCO CAIXA - 2023.xlsx
2023-10-20,PG ORG GOV DAS,201158,0.0,1734.06,"2.754,39",CAIXA,Despesas tributárias ,Outras,../data/raw/BANCO CAIXA - 2023.xlsx
2023-10-23,CRED TED FRESNOMAQ INDUSTRIA DE MAQUINA NFS-e 2370,341,4385.0,0.0,"7.139,39",CAIXA,Receita com serviços,Fresnomaq,../data/raw/BANCO CAIXA - 2023.xlsx
2023-10-27,CRED TED DAIKIN AR CONDICIONADO BRASIL NFS-e 2374,33,150.0,0.0,"7.289,39",CAIXA,Despesa com serviços,Outras,../data/raw/BANCO CAIXA - 2023.xlsx
2023-10-27,CRED TED SPRINGER CARRIER LTDA NFS-e 2371,341,4617.58,0.0,"11.906,97",CAIXA,Receita com serviços,Spring,../data/raw/BANCO CAIXA - 2023.xlsx
2023-10-30,PAG BOLETO VT BRENDA E CINTHYA,301210,0.0,447.03,"11.459,94",CAIXA,Despesa com pessoal,Transporte (VT),../data/raw/BANCO CAIXA - 2023.xlsx
2023-10-30,ENVIO PIX NICOLAS - PAGTO TERCEIROS,301904,0.0,400.0,"11.059,94",CAIXA,Despesa com serviços,Mão de obra,../data/raw/BANCO CAIXA - 2023.xlsx
2023-10-30,ENVIO PIX IRAN -TERMOS DE USO E POLÍTICA DE PRIVACIDADE - ECEEL-TEC,301912,0.0,1000.0,"10.059,94",CAIXA,Despesas administrativas,Outras,../data/raw/BANCO CAIXA - 2023.xlsx
2023-10-30,PAG BOLETO CRT CONSELHO REGIONAL DOS TÉCNICOS - PARC. 6/6,301922,0.0,193.14,"9.866,80",CAIXA,Despesa com pessoal,Outras,../data/raw/BANCO CAIXA - 2023.xlsx
2023-11-01,ENVIO PIX MATHEUS - VT ESTAGIÁRIO,11101,0.0,240.0,"9.626,80",CAIXA,Despesa com pessoal,Transporte (VT),../data/raw/BANCO CAIXA - 2023.xlsx
2023-11-01,ENVIO PIX MATHEUS - SERVIÇOS PRESTADOS,11106,0.0,300.0,"9.326,80",CAIXA,Despesa com serviços,Mão de obra,../data/raw/BANCO CAIXA - 2023.xlsx
2023-11-01,ENVIO PIX LUIZ,11111,0.0,200.0,"9.126,80",CAIXA,Despesa com pessoal,Outras,../data/raw/BANCO CAIXA - 2023.xlsx
2023-11-03,ENVIO PIX KAIO - SERVIÇOS PRESTADO,31900,0.0,288.0,"8.838,80",CAIXA,Despesa com serviços,Mão de obra,../data/raw/BANCO CAIXA - 2023.xlsx
2023-11-06,DB CEST PJ,102023,0.0,69.0,"8.769,80",CAIXA,Despesas financeiras,Despesas com cobrança,../data/raw/BANCO CAIXA - 2023.xlsx
2023-11-07,ENVIO PIX LARYSSA - PAGTO SERVIÇOS PRESTADOS,70930,0.0,2000.0,"6.769,80",CAIXA,Despesa com serviços,Mão de obra,../data/raw/BANCO CAIXA - 2023.xlsx
2023-11-07,ENVIO TEV ROBSON - PAGAMENTO DE SALÁRIO,70935,0.0,2302.09,"4.467,71",CAIXA,Despesa com pessoal,Salário,../data/raw/BANCO CAIXA - 2023.xlsx
2023-11-07,PAG FGTS,70939,0.0,959.29,"3.508,42",CAIXA,Despesa com pessoal,FGTS,../data/raw/BANCO CAIXA - 2023.xlsx
2023-11-07,ENVIO PIX CINTHYA - PAGAMENTO DE SALÁRIO,70955,0.0,1538.81,"1.969,61",CAIXA,Despesa com pessoal,Salário,../data/raw/BANCO CAIXA - 2023.xlsx
2023-11-07,ENVIO PIX BRENDA - PAGAMENTO DE SALÁRIO,70959,0.0,814.33,"1.155,28",CAIXA,Despesa com pessoal,Salário,../data/raw/BANCO CAIXA - 2023.xlsx
2023-11-07,ENVIO PIX CONTABILIDADE - HONORÁRIOS,71012,0.0,523.0,"632,28",CAIXA,Despesas administrativas,Contabilidade,../data/raw/BANCO CAIXA - 2023.xlsx
2023-11-10,CRED TED PANASONIC DO BRASIL LIMITADA NFS-e 2376,341,5575.38,0.0,"6.207,66",CAIXA,Receita com serviços,Panasonic,../data/raw/BANCO CAIXA - 2023.xlsx
2023-11-13,DP DIN LOT- RODRIGO,131659,120.0,0.0,"6.327,66",CAIXA,Despesa com serviços,Outras,../data/raw/BANCO CAIXA - 2023.xlsx
2023-11-20,"CRED TED SPRINGER CARRIER LTDA NFS-e 2389 E 2390 + 499,00",341,5722.95,0.0,"12.050,61",CAIXA,Receita com serviços,Spring,../data/raw/BANCO CAIXA - 2023.xlsx
2023-11-20,ENVIO PIX BRENDA - PAGAMENTO ADIANTAMENTO DE SALÁRIO,201453,0.0,696.04,"11.354,57",CAIXA,Despesa com pessoal,Salário,../data/raw/BANCO CAIXA - 2023.xlsx
2023-11-20,ENVIO PIX LUIZ GUILHERME - PAGTO ADIANTAMENTO DE SALÁRIO,201456,0.0,800.0,"10.554,57",CAIXA,Despesa com pessoal,Salário,../data/raw/BANCO CAIXA - 2023.xlsx
2023-11-20,PG ORG GOV - DAS,201500,0.0,1788.79,"8.765,78",CAIXA,Despesas tributárias ,Outras,../data/raw/BANCO CAIXA - 2023.xlsx
2023-11-20,PG ORG GOV - DARF/GPS,201503,0.0,1170.72,"7.595,06",CAIXA,Despesa com pessoal,INSS,../data/raw/BANCO CAIXA - 2023.xlsx
2023-11-20,PG ORG GOV - DARF ALUGUEL,201506,0.0,84.58,"7.510,48",CAIXA,Despesas administrativas,Aluguel imóvel,../data/raw/BANCO CAIXA - 2023.xlsx
2023-11-21,CRED TED FRESNOMAQ INDUSTRIA DE MAQUINA - NFS-e 2388,341,3707.5,0.0,"11.217,98",CAIXA,Receita com serviços,Fresnomaq,../data/raw/BANCO CAIXA - 2023.xlsx
2023-11-30,ENVIO TEV ROBSON - ADIANTAMENTO 13º SALÁRIO,301149,0.0,1045.0,"10.172,98",CAIXA,Despesa com pessoal,13º salário,../data/raw/BANCO CAIXA - 2023.xlsx
2023-11-30,ENVIO PIX BRENDA - ADIANTAMENTO 13º SALÁRIO,301214,0.0,362.52,"9.810,46",CAIXA,Despesa com pessoal,13º salário,../data/raw/BANCO CAIXA - 2023.xlsx
2023-11-30,ENVIO PIX CINTHYA - ADIANTAMENTO 13º SALÁRIO,301217,0.0,507.52,"9.302,94",CAIXA,Despesa com pessoal,13º salário,../data/raw/BANCO CAIXA - 2023.xlsx
2023-11-30,ENVIO PIX LUIZ - ADIANTAMENTO 13º SALÁRIO,301220,0.0,416.66,"8.886,28",CAIXA,Despesa com pessoal,13º salário,../data/raw/BANCO CAIXA - 2023.xlsx
2023-11-30,ENVIO PIX THIAGO - ADIANTAMENTO 13º SALÁRIO,301223,0.0,870.05,"8.016,23",CAIXA,Despesa com pessoal,13º salário,../data/raw/BANCO CAIXA - 2023.xlsx
2023-11-30,ENVIO PIX KAIO - VT ESTAGIÁRIO,301734,0.0,240.0,"7.776,23",CAIXA,Despesa com pessoal,Transporte (VT),../data/raw/BANCO CAIXA - 2023.xlsx
2023-11-30,ENVIO PIX MATHEUS - VT ESTAGIÁRIO,301739,0.0,192.0,"7.584,23",CAIXA,Despesa com pessoal,Transporte (VT),../data/raw/BANCO CAIXA - 2023.xlsx
2023-11-30,ENVIO PIX LUIZ,301742,0.0,200.0,"7.384,23",CAIXA,Despesa com pessoal,Outras,../data/raw/BANCO CAIXA - 2023.xlsx
2023-12-04,CRED TED BRASANITAS HOSPITALAR HIGIEN - NFS-e 2387,237,425.0,0.0,"7.809,23",CAIXA,Despesa com serviços,Outras,../data/raw/BANCO CAIXA - 2023.xlsx
2023-12-05,DB CEST PJ,112023,0.0,69.0,"7.740,23",CAIXA,Despesas financeiras,Despesas com cobrança,../data/raw/BANCO CAIXA - 2023.xlsx
2023-12-06,ENVIO TEV ROBSON - PAGTO DE SALÁRIO,61020,0.0,2545.05,"5.195,18",CAIXA,Despesa com pessoal,Salário,../data/raw/BANCO CAIXA - 2023.xlsx
2023-12-06,ENVIO PIX CINTHYA - PAGTO DE SALÁRIO,61031,0.0,1558.72,"3.636,46",CAIXA,Despesa com pessoal,Salário,../data/raw/BANCO CAIXA - 2023.xlsx
2023-12-06,ENVIO PIX LUIZ GUILHERME - PAGTO DE SALÁRIO,61033,0.0,1486.32,"2.150,14",CAIXA,Despesa com pessoal,Salário,../data/raw/BANCO CAIXA - 2023.xlsx
2023-12-06,ENVIO PIX TATYANA - PAGTO DE SALÁRIO,61036,0.0,1722.76,"427,38",CAIXA,Despesa com pessoal,Salário,../data/raw/BANCO CAIXA - 2023.xlsx
2023-12-11,CRED TED PANASONIC DO BRASIL LIMITADA NFS-e 2402,341,2928.48,0.0,"3.355,86",CAIXA,Receita com serviços,Panasonic,../data/raw/BANCO CAIXA - 2023.xlsx
2023-12-18,CRED TED DAIKIN AR CONDICIONADO BRASI NFS-e 2431,33,150.0,0.0,"3.505,86",CAIXA,Despesa com serviços,Outras,../data/raw/BANCO CAIXA - 2023.xlsx
2023-12-18,CRED TED DAIKIN AR CONDICIONADO BRASI NFS-e 2430,33,300.0,0.0,"3.805,86",CAIXA,Despesa com serviços,Outras,../data/raw/BANCO CAIXA - 2023.xlsx
2023-12-18,CRED TED DAIKIN AR CONDICIONADO BRASI NFS-e 2432,33,150.0,0.0,"3.955,86",CAIXA,Despesa com serviços,Outras,../data/raw/BANCO CAIXA - 2023.xlsx
2023-12-20,ENVIO TEV ROBSON - 13º SALÁRIO-PARCELA FINAL,200930,0.0,1187.57,"2.768,29",CAIXA,Despesa com pessoal,13º salário,../data/raw/BANCO CAIXA - 2023.xlsx
2023-12-20,CRED TED - PAGSEGURO INTERNET LTDA,290,1105.06,0.0,"3.873,35",CAIXA,Despesa com serviços,Outras,../data/raw/BANCO CAIXA - 2023.xlsx
2023-12-20,ENVIO PIX BRENDA - 13º SALÁRIO-PARCELA FINAL,201208,0.0,309.84,"3.563,51",CAIXA,Despesa com pessoal,13º salário,../data/raw/BANCO CAIXA - 2023.xlsx
2023-12-20,ENVIO PIX BRENDA - ADIANTAMENTO DE SALÁRIO,201211,0.0,696.04,"2.867,47",CAIXA,Despesa com pessoal,Salário,../data/raw/BANCO CAIXA - 2023.xlsx
2023-12-20,ENVIO PIX LUIZ - 13º SALÁRIO-PARCELA FINAL,201214,0.0,575.68,"2.291,79",CAIXA,Despesa com pessoal,13º salário,../data/raw/BANCO CAIXA - 2023.xlsx
2023-12-20,ENVIO PIX LUIZ - ADIANTAMENTO DE SALÁRIO,201220,0.0,800.0,"1.491,79",CAIXA,Despesa com pessoal,Salário,../data/raw/BANCO CAIXA - 2023.xlsx
2023-12-20,ENVIO PIX NICOLAS 13º SALÁRIO-PARCELA FINAL,201228,0.0,134.14,"1.357,65",CAIXA,Despesa com pessoal,13º salário,../data/raw/BANCO CAIXA - 2023.xlsx
2023-12-20,ENVIO PIX RONALDO - 13º SALÁRIO-PARCELA FINAL,201236,0.0,134.14,"1.223,51",CAIXA,Despesa com pessoal,13º salário,../data/raw/BANCO CAIXA - 2023.xlsx
2023-12-20,ENVIO PIX CINTHYA - 13º SALÁRIO-PARCELA FINAL,201245,0.0,431.42,"792,09",CAIXA,Despesa com pessoal,13º salário,../data/raw/BANCO CAIXA - 2023.xlsx
2023-12-20,ENVIO PIX THIAGO - 13º SALÁRIO-PARCELA FINAL,201253,0.0,733.56,"58,53",CAIXA,Despesa com pessoal,13º salário,../data/raw/BANCO CAIXA - 2023.xlsx
2023-12-20,CRED TED SPRINGER CARRIER LTDA - NFS-e 2434,341,6678.96,0.0,"6.737,49",CAIXA,Receita com serviços,Spring,../data/raw/BANCO CAIXA - 2023.xlsx
2023-12-21,CRED TED FRESNOMAQ INDUSTRIA DE MAQUINA - NFS-e 2433,341,2917.5,0.0,"9.654,99",CAIXA,Receita com serviços,Fresnomaq,../data/raw/BANCO CAIXA - 2023.xlsx
2023-12-28,CRED TED IN STORE SERVICOS LTDA NFS-e 2435,341,1884.17,0.0,"11.539,16",CAIXA,Despesa com serviços,Outras,../data/raw/BANCO CAIXA - 2023.xlsx
2023-01-04,CREDITO TED - PAGSEGURO INTERNET LTDA,33980074,569.94,0.0,1035.47,CRED CREA,Receita com serviços,Outras,../data/raw/BANCO CRED CREA - 2023.xlsx
2023-01-05,PG.P/INTERNET - CONTA DE AGUA,10003309,0.0,170.01,865.46,CRED CREA,Despesas administrativas,Água,../data/raw/BANCO CRED CREA - 2023.xlsx
2023-01-06,CREDITO TED - PAGSEGURO INTERNET LTDA,34321522,194.72,0.0,1060.18,CRED CREA,Receita com serviços,Outras,../data/raw/BANCO CRED CREA - 2023.xlsx
2023-01-09,CR.APL.RDCPOS - RESGATE DE APLICAÇÕES,227,7000.0,0.0,8060.18,CRED CREA,Transferência (Crédito),Aplicação,../data/raw/BANCO CRED CREA - 2023.xlsx
2023-01-09,PG.P/INTERNET - ALUGUEL,10006500,0.0,4078.93,3981.25,CRED CREA,Despesas administrativas,Aluguel imóvel,../data/raw/BANCO CRED CREA - 2023.xlsx
2023-01-09,PG.P/INTERNET - PAGTO ESTAGIARIOS,10006539,0.0,1820.76,2160.49,CRED CREA,Despesa com pessoal,Salário,../data/raw/BANCO CRED CREA - 2023.xlsx
2023-01-10,PREST.EMPREST 046/048,6,0.0,1418.47,742.02,CRED CREA,Despesas financeiras,Outras,../data/raw/BANCO CRED CREA - 2023.xlsx
2023-01-10,DB. ALLIANZ - SEGURO SPIN 6 DE 10,84624000166,0.0,184.78,557.24,CRED CREA,Despesas administrativas,Seguro veicular,../data/raw/BANCO CRED CREA - 2023.xlsx
2023-01-10,CREDITO TED - PAGSEGURO INTERNET LTDA,34031830,212.52,0.0,769.76,CRED CREA,Receita com serviços,Outras,../data/raw/BANCO CRED CREA - 2023.xlsx
2023-01-12,CREDITO TED - PAGSEGURO INTERNET LTDA,33966049,671.0,0.0,1440.76,CRED CREA,Receita com serviços,Outras,../data/raw/BANCO CRED CREA - 2023.xlsx
2023-01-13,PG.P/INTERNET - ENERGIA LJ 6,10002362,0.0,350.98,1089.78,CRED CREA,Despesas administrativas,Energia,../data/raw/BANCO CRED CREA - 2023.xlsx
2023-01-13,PG.P/INTERNET - ENERGIA LJ 3,10002348,0.0,119.9,969.88,CRED CREA,Despesas administrativas,Energia,../data/raw/BANCO CRED CREA - 2023.xlsx
2023-01-13,PG.P/INTERNET - ENERGIA LJ 4,10002358,0.0,80.19,889.69,CRED CREA,Despesas administrativas,Energia,../data/raw/BANCO CRED CREA - 2023.xlsx
2023-01-13,CREDITO TED - PAGSEGURO INTERNET LTDA,34131501,235.35,0.0,1125.04,CRED CREA,Receita com serviços,Outras,../data/raw/BANCO CRED CREA - 2023.xlsx
2023-01-16,DB. COTAS,19911,0.0,66.48,1058.56,CRED CREA,Despesas financeiras,Outras,../data/raw/BANCO CRED CREA - 2023.xlsx
2023-01-19,CREDITO TED - PAGSEGURO INTERNET LTDA,34267160,163.94,0.0,1222.5,CRED CREA,Receita com serviços,Outras,../data/raw/BANCO CRED CREA - 2023.xlsx
2023-01-20,DB. ALLIANZ - SEGURO MOTO 10 DE 10,84624000166,0.0,158.03,1064.47,CRED CREA,Despesas administrativas,Seguro veicular,../data/raw/BANCO CRED CREA - 2023.xlsx
2023-01-20,CREDITO TED - PAGSEGURO INTERNET LTDA,33861240,750.84,0.0,1815.31,CRED CREA,Receita com serviços,Outras,../data/raw/BANCO CRED CREA - 2023.xlsx
2023-01-20,PG.P/INTERNET - WHITE MARTINS,10006944,0.0,39.76,1775.55,CRED CREA,Despesa com produtos,Materiais de Consumo,../data/raw/BANCO CRED CREA - 2023.xlsx
2023-01-25,CREDITO TED - PAGSEGURO INTERNET LTDA,33675640,452.5,0.0,2228.05,CRED CREA,Receita com serviços,Outras,../data/raw/BANCO CRED CREA - 2023.xlsx
2023-01-25,PG.P/INTERNET - MED CURITIBA,10002272,0.0,200.0,2028.05,CRED CREA,Despesa com pessoal,Assistência médica,../data/raw/BANCO CRED CREA - 2023.xlsx
2023-01-25,PG.P/INTERNET - Ligga telecon,10002316,0.0,149.9,1878.15,CRED CREA,Despesas administrativas,"Telefonia (Celular, Fixo, Internet)",../data/raw/BANCO CRED CREA - 2023.xlsx
2023-01-25,PG.P/INTERNET - WHITE MARTINS,10002293,0.0,214.49,1663.66,CRED CREA,Despesa com produtos,Materiais de Consumo,../data/raw/BANCO CRED CREA - 2023.xlsx
2023-01-25,PG.P/INTERNET - NET FONE,10002303,0.0,123.6,1540.06,CRED CREA,Despesas administrativas,"Telefonia (Celular, Fixo, Internet)",../data/raw/BANCO CRED CREA - 2023.xlsx
2023-01-25,PG.P/INTERNET - CELULAR,10002325,0.0,57.61,1482.45,CRED CREA,Despesas administrativas,"Telefonia (Celular, Fixo, Internet)",../data/raw/BANCO CRED CREA - 2023.xlsx
2023-01-31,PG.P/INTERNET - VR BENEFICIOS E SERV. DE PROC.,10002809,0.0,1050.0,432.45,CRED CREA,Despesa com pessoal,Alimentação (VR VA),../data/raw/BANCO CRED CREA - 2023.xlsx
2023-02-01,CREDITO TED - PAGSEGURO INTERNET LTDA,34148926,93.06,0.0,525.51,CRED CREA,Receita com serviços,Outras,../data/raw/BANCO CRED CREA - 2023.xlsx
2023-02-03,PG.P/INTERNET - Guia de recolhimento,10003774,0.0,85.37,440.14,CRED CREA,Despesas financeiras,Outras,../data/raw/BANCO CRED CREA - 2023.xlsx
2023-02-03,PG.P/INTERNET - Guia de recolhimento,10003799,0.0,32.25,407.89,CRED CREA,Despesas financeiras,Outras,../data/raw/BANCO CRED CREA - 2023.xlsx
2023-02-03,PG.P/INTERNET - Guia de recolhimento,10003902,0.0,75.29,332.6,CRED CREA,Despesas financeiras,Outras,../data/raw/BANCO CRED CREA - 2023.xlsx
2023-02-03,PG.P/INTERNET - Guia de recolhimento,10003941,0.0,71.89,260.71,CRED CREA,Despesas financeiras,Outras,../data/raw/BANCO CRED CREA - 2023.xlsx
2023-02-03,CREDITO TED - PAGSEGURO INTERNET LTDA,34140130,197.0,0.0,457.71,CRED CREA,Receita com serviços,Outras,../data/raw/BANCO CRED CREA - 2023.xlsx
2023-02-06,CREDITO TED - PAGSEGURO INTERNET LTDA,34588410,135.24,0.0,592.95,CRED CREA,Receita com serviços,Outras,../data/raw/BANCO CRED CREA - 2023.xlsx
2023-02-10,PREST.EMPREST 047/048,6,0.0,592.95,,CRED CREA,Despesas financeiras,Outras,../data/raw/BANCO CRED CREA - 2023.xlsx
2023-02-10,CREDITO TED - PAGSEGURO INTERNET LTDA,34047929,144.9,0.0,144.9,CRED CREA,Receita com serviços,Outras,../data/raw/BANCO CRED CREA - 2023.xlsx
2023-02-10,PREST.EMPREST 047/048,11,0.0,144.9,,CRED CREA,Despesas financeiras,Outras,../data/raw/BANCO CRED CREA - 2023.xlsx
2023-02-10,CREDITO TED - PAGSEGURO INTERNET LTDA,34075770,1068.79,0.0,1068.79,CRED CREA,Receita com serviços,Outras,../data/raw/BANCO CRED CREA - 2023.xlsx
2023-02-10,PREST.EMPREST 047/048,13,0.0,680.62,388.17,CRED CREA,Despesas financeiras,Outras,../data/raw/BANCO CRED CREA - 2023.xlsx
2023-02-10,DB. ALLIANZ -SEGURO SPIN 7 DE 10,84624000166,0.0,184.78,203.39,CRED CREA,Despesas administrativas,Seguro veicular,../data/raw/BANCO CRED CREA - 2023.xlsx
2023-02-13,CREDITO TED - PAGSEGURO INTERNET LTDA,33037324,858.36,0.0,1061.75,CRED CREA,Receita com serviços,Outras,../data/raw/BANCO CRED CREA - 2023.xlsx
2023-02-15,DB. COTAS,19911,0.0,66.48,995.27,CRED CREA,Despesas financeiras,Outras,../data/raw/BANCO CRED CREA - 2023.xlsx
2023-02-15,CREDITO TED - PAGSEGURO INTERNET LTDA,34385159,488.58,0.0,1483.85,CRED CREA,Receita com serviços,Outras,../data/raw/BANCO CRED CREA - 2023.xlsx
2023-02-16,PG.P/INTERNET - REFRIGERACAO DUFRIO COMERCIO E,10003116,0.0,428.93,1054.92,CRED CREA,Despesa com produtos,Materiais de Consumo,../data/raw/BANCO CRED CREA - 2023.xlsx
2023-02-16,PG.P/INTERNET - ENERGIA LJ 3,10003130,0.0,88.16,966.76,CRED CREA,Despesas administrativas,Energia,../data/raw/BANCO CRED CREA - 2023.xlsx
2023-02-16,PG.P/INTERNET - ENERGIA LJ 6,10003139,0.0,278.38,688.38,CRED CREA,Despesas administrativas,Energia,../data/raw/BANCO CRED CREA - 2023.xlsx
2023-02-16,PG.P/INTERNET - ENERGIA LJ 4,10003135,0.0,21.85,666.53,CRED CREA,Despesas administrativas,Energia,../data/raw/BANCO CRED CREA - 2023.xlsx
2023-02-17,PG.P/INTERNET - DARF REFERENTE ALUGUEL,10005384,0.0,84.58,581.95,CRED CREA,Despesas administrativas,Aluguel imóvel,../data/raw/BANCO CRED CREA - 2023.xlsx
2023-02-17,PG.P/INTERNET - VR BENEFICIOS E SERV. DE PROC.,10005441,0.0,300.0,281.95,CRED CREA,Despesa com pessoal,Alimentação (VR VA),../data/raw/BANCO CRED CREA - 2023.xlsx
2023-02-23,CREDITO TED - PAGSEGURO INTERNET LTDA,34015265,1018.13,0.0,1300.08,CRED CREA,Receita com serviços,Outras,../data/raw/BANCO CRED CREA - 2023.xlsx
2023-02-23,PG.P/INTERNET - SPRINGER CARRIER,10003155,0.0,22.82,1277.26,CRED CREA,Despesa com produtos,Materiais de Consumo,../data/raw/BANCO CRED CREA - 2023.xlsx
2023-02-23,PG.P/INTERNET - SPRINGER CARRIER,10003180,0.0,556.85,720.41,CRED CREA,Despesa com produtos,Materiais de Consumo,../data/raw/BANCO CRED CREA - 2023.xlsx
2023-02-23,PG.P/INTERNET - SPRINGER CARRIER,10003283,0.0,58.66,661.75,CRED CREA,Despesa com produtos,Materiais de Consumo,../data/raw/BANCO CRED CREA - 2023.xlsx
2023-02-27,CREDITO TED - PAGSEGURO INTERNET LTDA,34259265,3940.0,0.0,4601.75,CRED CREA,Receita com serviços,Outras,../data/raw/BANCO CRED CREA - 2023.xlsx
2023-02-27,PG.P/INTERNET - VT ESTAGIARIO MATEUS,10004798,0.0,255.94,4345.81,CRED CREA,Despesa com pessoal,Transporte (VT),../data/raw/BANCO CRED CREA - 2023.xlsx
2023-02-27,PG.P/INTERNET - Ligga telecon,10004836,0.0,149.9,4195.91,CRED CREA,Despesas administrativas,"Telefonia (Celular, Fixo, Internet)",../data/raw/BANCO CRED CREA - 2023.xlsx
2023-02-27,PG.P/INTERNET - NET FONE,10004852,0.0,123.6,4072.31,CRED CREA,Despesas administrativas,"Telefonia (Celular, Fixo, Internet)",../data/raw/BANCO CRED CREA - 2023.xlsx
2023-02-27,PG.P/INTERNET - CELULAR,10004904,0.0,57.61,4014.7,CRED CREA,Despesas administrativas,"Telefonia (Celular, Fixo, Internet)",../data/raw/BANCO CRED CREA - 2023.xlsx
2023-02-27,PG.P/INTERNET - MED CURITIBA,10004928,0.0,517.0,3497.7,CRED CREA,Despesa com pessoal,Assistência médica,../data/raw/BANCO CRED CREA - 2023.xlsx
2023-02-27,PG.P/INTERNET - TAXA DE CORPO DE BOMBEIROS,10004945,0.0,113.19,3384.51,CRED CREA,Despesas tributárias ,Outras,../data/raw/BANCO CRED CREA - 2023.xlsx
2023-02-27,DEBITO PIX - VT - Matheus Laurentino da Rosa,207234063,0.0,253.0,3131.51,CRED CREA,Despesa com pessoal,Transporte (VT),../data/raw/BANCO CRED CREA - 2023.xlsx
2023-02-27,PIX TRANSF PAGADOR,207234063,0.0,0.76,3130.75,CRED CREA,Despesas financeiras,Outras,../data/raw/BANCO CRED CREA - 2023.xlsx
2023-02-28,PG.P/INTERNET - VR BENEFICIOS E SERV. DE PROC.,10002476,0.0,1410.0,1720.75,CRED CREA,Despesa com pessoal,Alimentação (VR VA),../data/raw/BANCO CRED CREA - 2023.xlsx
2023-03-03,PG.P/INTERNET - REFRIGERACAO DUFRIO COMERCIO E,10002462,0.0,307.72,1413.03,CRED CREA,Despesa com produtos,Materiais de Consumo,../data/raw/BANCO CRED CREA - 2023.xlsx
2023-03-03,PG.P/INTERNET - CONTA DE AGUA,10002572,0.0,166.15,1246.88,CRED CREA,Despesas administrativas,Água,../data/raw/BANCO CRED CREA - 2023.xlsx
2023-03-03,PG.P/INTERNET - Guia de recolhimento,10002641,0.0,215.15,1031.73,CRED CREA,Despesas tributárias ,Outras,../data/raw/BANCO CRED CREA - 2023.xlsx
2023-03-07,PG.P/INTERNET - FGTS,10003451,0.0,1010.28,21.45,CRED CREA,Despesa com pessoal,FGTS,../data/raw/BANCO CRED CREA - 2023.xlsx
2023-03-08,CREDITO TED - PAGSEGURO INTERNET LTDA,33894288,945.92,0.0,967.37,CRED CREA,Receita com serviços,Outras,../data/raw/BANCO CRED CREA - 2023.xlsx
2023-03-08,CR.APL.RDCPOS - RESGATE DE APLICAÇÕES,89,6000.0,0.0,6967.37,CRED CREA,Transferência (Crédito),Aplicação,../data/raw/BANCO CRED CREA - 2023.xlsx
2023-03-08,PG.P/INTERNET - ALUGUEL,10003671,0.0,4078.93,2888.44,CRED CREA,Despesas administrativas,Aluguel imóvel,../data/raw/BANCO CRED CREA - 2023.xlsx
2023-03-08,PG.P/INTERNET - PAGTO ESTAGIARIOS,10003694,0.0,1500.57,1387.87,CRED CREA,Despesa com pessoal,13º salário,../data/raw/BANCO CRED CREA - 2023.xlsx
2023-03-09,CREDITO PIX - ECEELTEC ELETROELETRONICA INFORMAT,212280440,300.0,0.0,1687.87,CRED CREA,Receita com serviços,Outras,../data/raw/BANCO CRED CREA - 2023.xlsx
2023-03-10,PREST.EMPREST 048/048,7,0.0,1418.47,269.4,CRED CREA,Despesas financeiras,Outras,../data/raw/BANCO CRED CREA - 2023.xlsx
2023-03-10,DB. ALLIANZ -SEGURO SPIN 8 DE 10,84624000166,0.0,184.78,84.62,CRED CREA,Despesas administrativas,Seguro veicular,../data/raw/BANCO CRED CREA - 2023.xlsx
2023-03-14,CREDITO TED - PAGSEGURO INTERNET LTDA,34018420,177.3,0.0,261.92,CRED CREA,Receita com serviços,Outras,../data/raw/BANCO CRED CREA - 2023.xlsx
2023-03-15,DB. COTAS,19911,0.0,66.48,195.44,CRED CREA,Despesas financeiras,Outras,../data/raw/BANCO CRED CREA - 2023.xlsx
2023-03-15,CREDITO TED - PAGSEGURO INTERNET LTDA,34158915,2427.58,0.0,2623.02,CRED CREA,Receita com serviços,Outras,../data/raw/BANCO CRED CREA - 2023.xlsx
2023-03-20,CREDITO TED - PAGSEGURO INTERNET LTDA,34062891,3135.42,0.0,5758.44,CRED CREA,Receita com serviços,Outras,../data/raw/BANCO CRED CREA - 2023.xlsx
2023-03-20,PG.P/INTERNET - DAS,10006084,0.0,2072.11,3686.33,CRED CREA,Despesas tributárias ,Outras,../data/raw/BANCO CRED CREA - 2023.xlsx
2023-03-20,PG.P/INTERNET - DARF,10006146,0.0,1352.03,2334.3,CRED CREA,Despesa com pessoal,INSS,../data/raw/BANCO CRED CREA - 2023.xlsx
2023-03-20,PG.P/INTERNET - DARF REF ALUGUEL,10006183,0.0,84.58,2249.72,CRED CREA,Despesas administrativas,Aluguel imóvel,../data/raw/BANCO CRED CREA - 2023.xlsx
2023-03-22,CREDITO TED - PAGSEGURO INTERNET LTDA,33021544,1748.57,0.0,3998.29,CRED CREA,Receita com serviços,Outras,../data/raw/BANCO CRED CREA - 2023.xlsx
2023-03-27,PG.P/INTERNET - NET FONE,10002535,0.0,123.6,3874.69,CRED CREA,Despesas administrativas,"Telefonia (Celular, Fixo, Internet)",../data/raw/BANCO CRED CREA - 2023.xlsx
2023-03-27,PG.P/INTERNET - CELULAR,10002566,0.0,57.61,3817.08,CRED CREA,Despesas administrativas,"Telefonia (Celular, Fixo, Internet)",../data/raw/BANCO CRED CREA - 2023.xlsx
2023-03-27,PG.P/INTERNET - Ligga telecon,10002606,0.0,149.9,3667.18,CRED CREA,Despesas administrativas,"Telefonia (Celular, Fixo, Internet)",../data/raw/BANCO CRED CREA - 2023.xlsx
2023-03-27,PG.P/INTERNET - SPRINGER CARRIER,10002623,0.0,22.81,3644.37,CRED CREA,Despesa com produtos,Materiais de Consumo,../data/raw/BANCO CRED CREA - 2023.xlsx
2023-03-27,PG.P/INTERNET - SPRINGER CARRIER,10002651,0.0,556.85,3087.52,CRED CREA,Despesa com produtos,Materiais de Consumo,../data/raw/BANCO CRED CREA - 2023.xlsx
2023-03-27,PG.P/INTERNET - MED CURITIBA,10002666,0.0,205.45,2882.07,CRED CREA,Despesa com pessoal,Assistência médica,../data/raw/BANCO CRED CREA - 2023.xlsx
2023-03-27,PG.P/INTERNET - EMBALATEC IND EMBALAGENS LTDA,10002701,0.0,1345.97,1536.1,CRED CREA,Despesa com produtos,Materiais de Consumo,../data/raw/BANCO CRED CREA - 2023.xlsx
2023-03-27,PG.P/INTERNET - MASTER FILME C EMBALAGENS LTDA,10002726,0.0,850.1,686,CRED CREA,Despesa com produtos,Materiais de Consumo,../data/raw/BANCO CRED CREA - 2023.xlsx
2023-03-29,CREDITO TED - PAGSEGURO INTERNET LTDA,33811964,88.65,0.0,774.65,CRED CREA,Receita com serviços,Outras,../data/raw/BANCO CRED CREA - 2023.xlsx
2023-03-29,PG.P/INTERNET - SPRINGER CARRIER,10002221,0.0,654.26,120.39,CRED CREA,Despesa com produtos,Materiais de Consumo,../data/raw/BANCO CRED CREA - 2023.xlsx
2023-03-30,CREDITO TED - PAGSEGURO INTERNET LTDA,33946036,860.71,0.0,981.1,CRED CREA,Receita com serviços,Outras,../data/raw/BANCO CRED CREA - 2023.xlsx
2023-03-30,PG.P/INTERNET - VR BENEFICIOS E SERV. DE PROC.,10003534,0.0,900.0,81.1,CRED CREA,Despesa com pessoal,Alimentação (VR VA),../data/raw/BANCO CRED CREA - 2023.xlsx
2023-03-31,CREDITO TED - PAGSEGURO INTERNET LTDA,34129883,623.65,0.0,704.75,CRED CREA,Receita com serviços,Outras,../data/raw/BANCO CRED CREA - 2023.xlsx
2023-03-31,PG.P/INTERNET - SPRINGER CARRIER,10004680,0.0,452.13,252.62,CRED CREA,Despesa com produtos,Materiais de Consumo,../data/raw/BANCO CRED CREA - 2023.xlsx
2023-04-04,CREDITO TED - PAGSEGURO INTERNET LTDA,33899696,1583.66,0.0,1836.28,CRED CREA,Receita com serviços,Outras,../data/raw/BANCO CRED CREA - 2023.xlsx
2023-04-05,CREDITO TED - PAGSEGURO INTERNET LTDA,34180730,115.92,0.0,1952.2,CRED CREA,Receita com serviços,Outras,../data/raw/BANCO CRED CREA - 2023.xlsx
2023-04-05,PG.P/INTERNET - CONTA DE AGUA,10005926,0.0,170.01,1782.19,CRED CREA,Despesas administrativas,Água,../data/raw/BANCO CRED CREA - 2023.xlsx
2023-04-05,PG.P/INTERNET - WHITE MARTINS,10006114,0.0,39.76,1742.43,CRED CREA,Despesa com produtos,Materiais de Consumo,../data/raw/BANCO CRED CREA - 2023.xlsx
2023-04-06,CREDITO TED - PAGSEGURO INTERNET LTDA,34144905,1254.02,0.0,2996.45,CRED CREA,Receita com serviços,Outras,../data/raw/BANCO CRED CREA - 2023.xlsx
2023-04-06,PG.P/INTERNET - CIEE - PR,10006870,0.0,2380.95,615.5,CRED CREA,Despesa com pessoal,Outras,../data/raw/BANCO CRED CREA - 2023.xlsx
2023-04-10,DB. ALLIANZ -SEGURO SPIN 9 DE 10,84624000166,0.0,184.78,430.72,CRED CREA,Despesas administrativas,Seguro veicular,../data/raw/BANCO CRED CREA - 2023.xlsx
2023-04-13,CREDITO TED - PAGSEGURO INTERNET LTDA,33020007,1621.16,0.0,2051.88,CRED CREA,Receita com serviços,Outras,../data/raw/BANCO CRED CREA - 2023.xlsx
2023-04-14,CREDITO TED - PAGSEGURO INTERNET LTDA,33929539,761.35,0.0,2813.23,CRED CREA,Receita com serviços,Outras,../data/raw/BANCO CRED CREA - 2023.xlsx
2023-04-17,DB. COTAS,19911,0.0,66.48,2746.75,CRED CREA,Despesas financeiras,Outras,../data/raw/BANCO CRED CREA - 2023.xlsx
2023-04-17,CREDITO TED - PAGSEGURO INTERNET LTDA,34345619,343.65,0.0,3090.4,CRED CREA,Receita com serviços,Outras,../data/raw/BANCO CRED CREA - 2023.xlsx
2023-04-18,DB. ALLIANZ -SEGURO MOTO 1 DE 10,84624000166,0.0,146.46,2943.94,CRED CREA,Despesas administrativas,Seguro veicular,../data/raw/BANCO CRED CREA - 2023.xlsx
2023-04-20,CREDITO TED - PAGSEGURO INTERNET LTDA,34175294,1180.37,0.0,4124.31,CRED CREA,Receita com serviços,Outras,../data/raw/BANCO CRED CREA - 2023.xlsx
2023-04-25,CREDITO TED - PAGSEGURO INTERNET LTDA,33949804,2318.53,0.0,6442.84,CRED CREA,Receita com serviços,Outras,../data/raw/BANCO CRED CREA - 2023.xlsx
2023-05-04,CREDITO TED - PAGSEGURO INTERNET LTDA,33877425,108.35,0.0,6551.19,CRED CREA,Despesas administrativas,Água,../data/raw/BANCO CRED CREA - 2023.xlsx
2023-05-04,PG.P/INTERNET - CONTA DE AGUA,10003686,0.0,246.82,6304.37,CRED CREA,Despesa com produtos,Materiais de Consumo,../data/raw/BANCO CRED CREA - 2023.xlsx
2023-05-04,PG.P/INTERNET - WHITE MARTINS,10003706,0.0,150.34,6154.03,CRED CREA,Despesa com produtos,Materiais de Consumo,../data/raw/BANCO CRED CREA - 2023.xlsx
2023-05-04,PG.P/INTERNET - SPRINGER CARRIER,10003719,0.0,452.12,5701.91,CRED CREA,Despesa com produtos,Materiais de Consumo,../data/raw/BANCO CRED CREA - 2023.xlsx
2023-05-04,PG.P/INTERNET - SPRINGER CARRIER,10003738,0.0,673.13,5028.78,CRED CREA,Receita com serviços,Outras,../data/raw/BANCO CRED CREA - 2023.xlsx
2023-05-08,CREDITO TED - PAGSEGURO INTERNET LTDA,34055858,1058.52,0.0,6087.3,CRED CREA,Despesas administrativas,Seguro veicular,../data/raw/BANCO CRED CREA - 2023.xlsx
2023-05-10,DB. ALLIANZ -SEGURO SPIN 10 DE 10,84624000166,0.0,184.89,5902.41,CRED CREA,Receita com serviços,Outras,../data/raw/BANCO CRED CREA - 2023.xlsx
2023-05-11,CREDITO TED - PAGSEGURO INTERNET LTDA,33876217,1727.33,0.0,7629.74,CRED CREA,Receita com serviços,Outras,../data/raw/BANCO CRED CREA - 2023.xlsx
2023-05-12,CREDITO TED - PAGSEGURO INTERNET LTDA,33830885,1376.55,0.0,9006.29,CRED CREA,Despesas administrativas,Energia,../data/raw/BANCO CRED CREA - 2023.xlsx
2023-05-12,PG.P/INTERNET - ENERGIA LJ 3,10003146,0.0,159.77,8846.52,CRED CREA,Despesas administrativas,Energia,../data/raw/BANCO CRED CREA - 2023.xlsx
2023-05-12,PG.P/INTERNET - ENERGIA LJ 6,10003188,0.0,389.87,8456.65,CRED CREA,Despesas administrativas,Energia,../data/raw/BANCO CRED CREA - 2023.xlsx
2023-05-12,PG.P/INTERNET - ENERGIA LJ 4,10003169,0.0,48.71,8407.94,CRED CREA,Despesas financeiras,Outras,../data/raw/BANCO CRED CREA - 2023.xlsx
2023-05-15,DB. COTAS,19911,0.0,66.48,8341.46,CRED CREA,Receita com serviços,Outras,../data/raw/BANCO CRED CREA - 2023.xlsx
2023-05-16,CREDITO TED - PAGSEGURO INTERNET LTDA,35181214,1293.24,0.0,9634.7,CRED CREA,Receita com serviços,Outras,../data/raw/BANCO CRED CREA - 2023.xlsx
2023-05-19,CREDITO TED - PAGSEGURO INTERNET LTDA,33577502,2145.57,0.0,11780.27,CRED CREA,Despesas tributárias ,Outras,../data/raw/BANCO CRED CREA - 2023.xlsx
2023-05-19,PG.P/INTERNET - DAS,10003080,0.0,2569.17,9211.1,CRED CREA,Despesas administrativas,Seguro veicular,../data/raw/BANCO CRED CREA - 2023.xlsx
2023-05-22,DB. ALLIANZ -SEGURO MOTO 2 DE 10,84624000166,0.0,146.46,9064.64,CRED CREA,Despesa com pessoal,Assistência médica,../data/raw/BANCO CRED CREA - 2023.xlsx
2023-05-23,PG.P/INTERNET - MED CURITIBA,10001808,0.0,134.54,8930.1,CRED CREA,Despesas administrativas,"Telefonia (Celular, Fixo, Internet)",../data/raw/BANCO CRED CREA - 2023.xlsx
2023-05-23,PG.P/INTERNET - NET FONE,10001814,0.0,123.6,8806.5,CRED CREA,Despesas administrativas,"Telefonia (Celular, Fixo, Internet)",../data/raw/BANCO CRED CREA - 2023.xlsx
2023-05-23,PG.P/INTERNET - CELULAR,10001819,0.0,57.61,8748.89,CRED CREA,Despesas administrativas,"Telefonia (Celular, Fixo, Internet)",../data/raw/BANCO CRED CREA - 2023.xlsx
2023-05-23,PG.P/INTERNET - Ligga telecon,10001823,0.0,149.9,8598.99,CRED CREA,Receita com serviços,Outras,../data/raw/BANCO CRED CREA - 2023.xlsx
2023-05-23,CREDITO TED - PAGSEGURO INTERNET LTDA,33862781,557.73,0.0,9156.72,CRED CREA,Receita com serviços,Outras,../data/raw/BANCO CRED CREA - 2023.xlsx
2023-05-26,CREDITO TED - PAGSEGURO INTERNET LTDA,33478362,1605.87,0.0,10762.59,CRED CREA,Despesa com produtos,Materiais de Consumo,../data/raw/BANCO CRED CREA - 2023.xlsx
2023-05-26,PG.P/INTERNET - SPRINGER CARRIER,10001448,0.0,492.35,10270.24,CRED CREA,Despesa com produtos,Materiais de Consumo,../data/raw/BANCO CRED CREA - 2023.xlsx
2023-05-26,PG.P/INTERNET - SPRINGER CARRIER,10001464,0.0,654.26,9615.98,CRED CREA,Despesa com produtos,Materiais de Consumo,../data/raw/BANCO CRED CREA - 2023.xlsx
2023-05-26,PG.P/INTERNET - MASTER FILME C EMBALAGENS LTDA,10001504,0.0,850.09,8765.89,CRED CREA,Despesas administrativas,Contabilidade,../data/raw/BANCO CRED CREA - 2023.xlsx
2023-06-02,CREDITO TED - PAGSEGURO INTERNET LTDA,34550764,3548.42,0.0,12121.17,CRED CREA,Receita com serviços,Outras,../data/raw/BANCO CRED CREA - 2023.xlsx
2023-06-05,CREDITO TED - PAGSEGURO INTERNET LTDA,34800101,615.31,0.0,12736.48,CRED CREA,Receita com serviços,Outras,../data/raw/BANCO CRED CREA - 2023.xlsx
2023-06-07,CREDITO TED - PAGSEGURO INTERNET LTDA,34406489,487.83,0.0,13224.31,CRED CREA,Receita com serviços,Outras,../data/raw/BANCO CRED CREA - 2023.xlsx
2023-06-09,PG.P/INTERNET - WHITE MARTINS,10007212,0.0,39.76,13184.55,CRED CREA,Despesa com produtos,Materiais de Consumo,../data/raw/BANCO CRED CREA - 2023.xlsx
2023-06-14,CREDITO TED - PAGSEGURO INTERNET LTDA,34209001,1020.14,0.0,14204.69,CRED CREA,Receita com serviços,Outras,../data/raw/BANCO CRED CREA - 2023.xlsx
2023-06-15,DB. COTAS,19911,0.0,66.48,14138.21,CRED CREA,Despesas financeiras,Outras,../data/raw/BANCO CRED CREA - 2023.xlsx
2023-06-20,DB. ALLIANZ -SEGURO MOTO 3 DE 10,84624000166,0.0,146.46,13991.75,CRED CREA,Despesas administrativas,Seguro veicular,../data/raw/BANCO CRED CREA - 2023.xlsx
2023-06-21,CREDITO TED - PAGSEGURO INTERNET LTDA,34076224,991.76,0.0,14983.51,CRED CREA,Receita com serviços,Outras,../data/raw/BANCO CRED CREA - 2023.xlsx
2023-06-23,CREDITO TED - PAGSEGURO INTERNET LTDA,33864047,1239.86,0.0,16223.37,CRED CREA,Receita com serviços,Outras,../data/raw/BANCO CRED CREA - 2023.xlsx
2023-06-29,CREDITO TED - PAGSEGURO INTERNET LTDA,33556367,518.99,0.0,16742.36,CRED CREA,Receita com serviços,Outras,../data/raw/BANCO CRED CREA - 2023.xlsx
2023-07-07,CREDITO TED - PAGSEGURO INTERNET LTDA,34018653,1102.12,0.0,17844.48,CRED CREA,Receita com serviços,Outras,../data/raw/BANCO CRED CREA - 2023.xlsx
2023-07-11,CREDITO TED - PAGSEGURO INTERNET LTDA,34113765,598.92,0.0,18443.4,CRED CREA,Receita com serviços,Outras,../data/raw/BANCO CRED CREA - 2023.xlsx
2023-07-14,CREDITO TED - PAGSEGURO INTERNET LTDA,33715582,2175.49,0.0,20618.89,CRED CREA,Receita com serviços,Outras,../data/raw/BANCO CRED CREA - 2023.xlsx
2023-07-17,DB. COTAS,19911,0.0,66.48,20552.41,CRED CREA,Despesas financeiras,Outras,../data/raw/BANCO CRED CREA - 2023.xlsx
2023-07-20,DB. ALLIANZ - SEGURO MOTO 4 DE 10,84624000166,0.0,146.46,20405.95,CRED CREA,Despesas administrativas,Seguro veicular,../data/raw/BANCO CRED CREA - 2023.xlsx
2023-07-21,CREDITO TED - PAGSEGURO INTERNET LTDA,34216176,1620.67,0.0,22026.62,CRED CREA,Receita com serviços,Outras,../data/raw/BANCO CRED CREA - 2023.xlsx
2023-07-26,CREDITO TED - PAGSEGURO INTERNET LTDA,33010389,2883.52,0.0,24910.14,CRED CREA,Receita com serviços,Outras,../data/raw/BANCO CRED CREA - 2023.xlsx
2023-07-27,PG.P/INTERNET - VALE TRANSPORTE CINTHYA,10002109,0.0,278.94,24631.2,CRED CREA,Despesa com pessoal,Transporte (VT),../data/raw/BANCO CRED CREA - 2023.xlsx
2023-07-27,PG.P/INTERNET - CONSELHO REGIONAL DOS TECNICOS -3/6 PARCELAS,10002163,0.0,193.14,24438.06,CRED CREA,Despesas administrativas,Contabilidade,../data/raw/BANCO CRED CREA - 2023.xlsx
2023-07-28,CREDITO TED - PAGSEGURO INTERNET LTDA,34327046,1178.32,0.0,25616.38,CRED CREA,Receita com serviços,Outras,../data/raw/BANCO CRED CREA - 2023.xlsx
2023-07-31,PIX TRANSF PAGADOR,273443599,0.0,4.99,25611.39,CRED CREA,Despesas financeiras,Outras,../data/raw/BANCO CRED CREA - 2023.xlsx
2023-07-31,DEBITO PIX - Elisabete Seolin Galindo - DIVISÃO DE LUCRO,273443599,0.0,10000.0,15611.39,CRED CREA,Transferência (Débito),Reserva de Capital,../data/raw/BANCO CRED CREA - 2023.xlsx
2023-07-31,PIX TRANSF PAGADOR,273621972,0.0,4.99,15606.4,CRED CREA,Despesas financeiras,Outras,../data/raw/BANCO CRED CREA - 2023.xlsx
2023-07-31,DEBITO PIX - Claudio Vinicius Galindo - DIVISÃO DE LUCRO,273621972,0.0,10000.0,5606.4,CRED CREA,Transferência (Débito),Reserva de Capital,../data/raw/BANCO CRED CREA - 2023.xlsx
2023-08-04,CREDITO TED - PAGSEGURO INTERNET LTDA,33012105,3081.69,0.0,8688.09,CRED CREA,Receita com serviços,Outras,../data/raw/BANCO CRED CREA - 2023.xlsx
2023-08-07,CREDITO TED - PAGSEGURO INTERNET LTDA,34910121,1332.24,0.0,10020.33,CRED CREA,Receita com serviços,Outras,../data/raw/BANCO CRED CREA - 2023.xlsx
2023-08-07,PG.P/INTERNET - SPRINGER CARRIER,10010303,0.0,284.0,9736.33,CRED CREA,Despesa com produtos,Materiais de Consumo,../data/raw/BANCO CRED CREA - 2023.xlsx
2023-08-07,PG.P/INTERNET - CIEE - PR,10010353,0.0,1230.69,8505.64,CRED CREA,Despesa com pessoal,Outras,../data/raw/BANCO CRED CREA - 2023.xlsx
2023-08-07,PG.P/INTERNET - VT - BRENDA,10010386,0.0,231.03,8274.61,CRED CREA,Despesa com pessoal,Transporte (VT),../data/raw/BANCO CRED CREA - 2023.xlsx
2023-08-07,PG.P/INTERNET - WHITE MARTINS,10010470,0.0,39.76,8234.85,CRED CREA,Despesa com produtos,Materiais de Consumo,../data/raw/BANCO CRED CREA - 2023.xlsx
2023-08-11,CREDITO TED - PAGSEGURO INTERNET LTDA,34241320,1008.85,0.0,9243.7,CRED CREA,Receita com serviços,Outras,../data/raw/BANCO CRED CREA - 2023.xlsx
2023-08-11,PG.P/INTERNET - VR BENEFICIOS - BRENDA E LUIZ,10003477,0.0,474.0,8769.7,CRED CREA,Despesa com pessoal,Alimentação (VR VA),../data/raw/BANCO CRED CREA - 2023.xlsx
2023-08-15,DB. COTAS,19911,0.0,66.48,8703.22,CRED CREA,Despesas financeiras,Outras,../data/raw/BANCO CRED CREA - 2023.xlsx
2023-08-15,DB. ALLIANZ - SEGURO SPIN 1 DE 10,84624000166,0.0,184.61,8518.61,CRED CREA,Despesas administrativas,Seguro veicular,../data/raw/BANCO CRED CREA - 2023.xlsx
2023-08-15,PG.P/INTERNET - PAGTO CARTAO AMERICAN,10005184,0.0,2135.39,6383.22,CRED CREA,Despesas administrativas,Outras,../data/raw/BANCO CRED CREA - 2023.xlsx
2023-08-15,PG.P/INTERNET - PAGTO ENERGIA LJ 3,10005232,0.0,150.85,6232.37,CRED CREA,Despesas administrativas,Energia,../data/raw/BANCO CRED CREA - 2023.xlsx
2023-08-15,PG.P/INTERNET - PAGTO ENERGIA LJ 4,10005259,0.0,56.59,6175.78,CRED CREA,Despesas administrativas,Energia,../data/raw/BANCO CRED CREA - 2023.xlsx
2023-08-15,PG.P/INTERNET - PAGTO ENERGIA LJ 6,10005275,0.0,453.45,5722.33,CRED CREA,Despesas administrativas,Energia,../data/raw/BANCO CRED CREA - 2023.xlsx
2023-08-15,PG.P/INTERNET - SPRINGER CARRIER,10005329,0.0,712.29,5010.04,CRED CREA,Despesa com produtos,Materiais de Consumo,../data/raw/BANCO CRED CREA - 2023.xlsx
2023-08-15,PG.P/INTERNET - DARF-GPS,10005418,0.0,1170.72,3839.32,CRED CREA,Despesa com pessoal,INSS,../data/raw/BANCO CRED CREA - 2023.xlsx
2023-08-15,CREDITO TED - PAGSEGURO INTERNET LTDA,34818418,3244.3,0.0,7083.62,CRED CREA,Receita com serviços,Outras,../data/raw/BANCO CRED CREA - 2023.xlsx
2023-08-18,CREDITO TED - PAGSEGURO INTERNET LTDA,33978541,1206.62,0.0,8290.24,CRED CREA,Receita com serviços,Outras,../data/raw/BANCO CRED CREA - 2023.xlsx
2023-08-18,PG.P/INTERNET - SPRINGER CARRIER,10004043,0.0,306.28,7983.96,CRED CREA,Despesa com produtos,Materiais de Consumo,../data/raw/BANCO CRED CREA - 2023.xlsx
2023-08-18,PG.P/INTERNET - WAP -FRESNOMAQ IND DE MAQ SA,10004075,0.0,173.18,7810.78,CRED CREA,Despesa com produtos,Materiais de Consumo,../data/raw/BANCO CRED CREA - 2023.xlsx
2023-08-18,PG.P/INTERNET - REFRIGERACAO DUFRIO COMERCIO E,10004101,0.0,364.16,7446.62,CRED CREA,Despesa com produtos,Materiais de Consumo,../data/raw/BANCO CRED CREA - 2023.xlsx
2023-08-21,DB. ALLIANZ - SEGURO MOTO 5 DE 10,84624000166,0.0,146.46,7300.16,CRED CREA,Despesas administrativas,Seguro veicular,../data/raw/BANCO CRED CREA - 2023.xlsx
2023-08-22,PG.P/INTERNET - SPRINGER CARRIER,10001382,0.0,395.11,6905.05,CRED CREA,Despesa com produtos,Materiais de Consumo,../data/raw/BANCO CRED CREA - 2023.xlsx
2023-08-22,PG.P/INTERNET - CELULAR,10001404,0.0,64.54,6840.51,CRED CREA,Despesas administrativas,"Telefonia (Celular, Fixo, Internet)",../data/raw/BANCO CRED CREA - 2023.xlsx
2023-08-22,PG.P/INTERNET - LIGGA TELECOM,10001414,0.0,149.9,6690.61,CRED CREA,Despesas administrativas,"Telefonia (Celular, Fixo, Internet)",../data/raw/BANCO CRED CREA - 2023.xlsx
2023-08-22,PG.P/INTERNET - NET FONE,10001432,0.0,136.0,6554.61,CRED CREA,Despesas administrativas,"Telefonia (Celular, Fixo, Internet)",../data/raw/BANCO CRED CREA - 2023.xlsx
2023-08-23,CREDITO TED - PAGSEGURO INTERNET LTDA,34099600,2795.62,0.0,9350.23,CRED CREA,Receita com serviços,Outras,../data/raw/BANCO CRED CREA - 2023.xlsx
2023-08-25,PG.P/INTERNET - MED CURITIBA,10003559,0.0,411.24,8938.99,CRED CREA,Despesa com pessoal,Assistência médica,../data/raw/BANCO CRED CREA - 2023.xlsx
2023-08-29,CREDITO TED - PAGSEGURO INTERNET LTDA,34075376,1633.88,0.0,10572.87,CRED CREA,Receita com serviços,Outras,../data/raw/BANCO CRED CREA - 2023.xlsx
2023-08-29,PG.P/INTERNET - VT - BRENDA E CINTHYA,10002367,0.0,459.03,10113.84,CRED CREA,Despesa com pessoal,Transporte (VT),../data/raw/BANCO CRED CREA - 2023.xlsx
2023-08-31,PG.P/INTERNET - CONSELHO REGIONAL DOS TECNICOS -4/6 PARCELAS,10003805,0.0,193.14,9920.7,CRED CREA,Despesa com pessoal,Outras,../data/raw/BANCO CRED CREA - 2023.xlsx
2023-08-31,PG.P/INTERNET - VR BENEFICIOS E SERV. DE PROC.,10003821,0.0,1400.0,8520.7,CRED CREA,Despesa com pessoal,Alimentação (VR VA),../data/raw/BANCO CRED CREA - 2023.xlsx
2023-09-04,CREDITO TED - PAGSEGURO INTERNET LTDA,33860586,1162.67,0.0,9683.37,CRED CREA,Receita com serviços,Outras,../data/raw/BANCO CRED CREA - 2023.xlsx
2023-09-04,PG.P/INTERNET - CONTA DE AGUA,10003986,0.0,204.88,9478.49,CRED CREA,Despesas administrativas,Água,../data/raw/BANCO CRED CREA - 2023.xlsx
2023-09-04,PG.P/INTERNET - PACKPAR EMBALAGENS EIRELI,10004000,0.0,395.28,9083.21,CRED CREA,Despesa com produtos,Materiais de Consumo,../data/raw/BANCO CRED CREA - 2023.xlsx
2023-09-06,CREDITO TED - PAGSEGURO INTERNET LTDA,33894772,1492.96,0.0,10576.17,CRED CREA,Receita com serviços,Outras,../data/raw/BANCO CRED CREA - 2023.xlsx
2023-09-06,PG.P/INTERNET - ALUGUEL,10006897,0.0,4707.97,5868.2,CRED CREA,Despesas administrativas,Aluguel imóvel,../data/raw/BANCO CRED CREA - 2023.xlsx
2023-09-06,PG.P/INTERNET - WHITE MARTINS,10007053,0.0,39.76,5828.44,CRED CREA,Despesa com produtos,Materiais de Consumo,../data/raw/BANCO CRED CREA - 2023.xlsx
2023-09-11,DB. ALLIANZ - SEGURO SPIN 2 DE 10,84624000166,0.0,184.61,5643.83,CRED CREA,Despesas administrativas,Seguro veicular,../data/raw/BANCO CRED CREA - 2023.xlsx
2023-09-14,CREDITO TED - PAGSEGURO INTERNET LTDA,34121209,827.77,0.0,6471.6,CRED CREA,Receita com serviços,Outras,../data/raw/BANCO CRED CREA - 2023.xlsx
2023-09-14,PG.P/INTERNET - CARTAO AMERICAN,10003235,0.0,1901.57,4570.03,CRED CREA,Despesas administrativas,Outras,../data/raw/BANCO CRED CREA - 2023.xlsx
2023-09-14,PG.P/INTERNET - ENERGIA LJ 3,10003261,0.0,145.04,4424.99,CRED CREA,Despesas administrativas,Energia,../data/raw/BANCO CRED CREA - 2023.xlsx
2023-09-14,PG.P/INTERNET - ENERGIA LJ 4,10003277,0.0,57.88,4367.11,CRED CREA,Despesas administrativas,Energia,../data/raw/BANCO CRED CREA - 2023.xlsx
2023-09-14,PG.P/INTERNET - ENERGIA LJ 6,10003299,0.0,384.16,3982.95,CRED CREA,Despesas administrativas,Energia,../data/raw/BANCO CRED CREA - 2023.xlsx
2023-09-14,PG.P/INTERNET - SPRINGER CARRIER,10003319,0.0,712.27,3270.68,CRED CREA,Despesa com produtos,Materiais de Consumo,../data/raw/BANCO CRED CREA - 2023.xlsx
2023-09-15,DB. COTAS,19911,0.0,69.5,3201.18,CRED CREA,Despesas financeiras,Outras,../data/raw/BANCO CRED CREA - 2023.xlsx
2023-09-15,CREDITO TED - PAGSEGURO INTERNET LTDA,34336356,1215.37,0.0,4416.55,CRED CREA,Receita com serviços,Outras,../data/raw/BANCO CRED CREA - 2023.xlsx
2023-09-20,CREDITO TED - PAGSEGURO INTERNET LTDA,33777096,860.84,0.0,5277.39,CRED CREA,Receita com serviços,Outras,../data/raw/BANCO CRED CREA - 2023.xlsx
2023-09-20,PG.P/INTERNET - SPRINGER CARRIER,10004018,0.0,306.28,4971.11,CRED CREA,Despesa com produtos,Materiais de Consumo,../data/raw/BANCO CRED CREA - 2023.xlsx
2023-09-22,CREDITO TED - PAGSEGURO INTERNET LTDA,34230246,3464.48,0.0,8435.59,CRED CREA,Receita com serviços,Outras,../data/raw/BANCO CRED CREA - 2023.xlsx
2023-09-25,PG.P/INTERNET - NET FONE,10003734,0.0,136.0,8299.59,CRED CREA,Despesas administrativas,"Telefonia (Celular, Fixo, Internet)",../data/raw/BANCO CRED CREA - 2023.xlsx
2023-09-25,PG.P/INTERNET - CELULAR,10003747,0.0,64.54,8235.05,CRED CREA,Despesas administrativas,"Telefonia (Celular, Fixo, Internet)",../data/raw/BANCO CRED CREA - 2023.xlsx
2023-09-25,PG.P/INTERNET - LIGGA TELECOM,10003751,0.0,149.9,8085.15,CRED CREA,Despesas administrativas,"Telefonia (Celular, Fixo, Internet)",../data/raw/BANCO CRED CREA - 2023.xlsx
2023-09-25,PG.P/INTERNET - SPRINGER CARRIER,10003795,0.0,395.1,7690.05,CRED CREA,Despesa com produtos,Materiais de Consumo,../data/raw/BANCO CRED CREA - 2023.xlsx
2023-09-26,CREDITO TED - PAGSEGURO INTERNET LTDA,34040819,593.45,0.0,8283.5,CRED CREA,Receita com serviços,Outras,../data/raw/BANCO CRED CREA - 2023.xlsx
2023-09-27,CREDITO TED - PAGSEGURO INTERNET LTDA,33984873,260.82,0.0,8544.32,CRED CREA,Receita com serviços,Outras,../data/raw/BANCO CRED CREA - 2023.xlsx
2023-09-28,CREDITO TED - PAGSEGURO INTERNET LTDA,34239646,1000.28,0.0,9544.6,CRED CREA,Receita com serviços,Outras,../data/raw/BANCO CRED CREA - 2023.xlsx
2023-10-02,CREDITO TED - PAGSEGURO INTERNET LTDA,34830699,883.81,0.0,10428.41,CRED CREA,Receita com serviços,Outras,../data/raw/BANCO CRED CREA - 2023.xlsx
2023-10-04,PG.P/INTERNET - CONTA DE AGUA,10004811,0.0,225.65,10202.76,CRED CREA,Despesas administrativas,Água,../data/raw/BANCO CRED CREA - 2023.xlsx
2023-10-04,PG.P/INTERNET - SPRINGER CARRIER,10004824,0.0,98.35,10104.41,CRED CREA,Despesa com produtos,Materiais de Consumo,../data/raw/BANCO CRED CREA - 2023.xlsx
2023-10-04,PG.P/INTERNET - FGTS,10004833,0.0,974.51,9129.9,CRED CREA,Despesa com pessoal,FGTS,../data/raw/BANCO CRED CREA - 2023.xlsx
2023-10-05,CR.EMPRESTIMO,1,80000.0,0.0,89129.9,CRED CREA,Outras entradas,Empréstimo contratado,../data/raw/BANCO CRED CREA - 2023.xlsx
2023-10-05,CR.APL.RDCPOS - RESGATE DE APLICAÇÕES,78,2166.11,0.0,91296.01,CRED CREA,Outras entradas,Outras,../data/raw/BANCO CRED CREA - 2023.xlsx
2023-10-05,CR.APL.RDCPOS - RESGATE DE APLICAÇÕES,79,3833.88,0.0,95129.89,CRED CREA,Outras entradas,Outras,../data/raw/BANCO CRED CREA - 2023.xlsx
2023-10-05,PIX TRANSF PAGADOR,304872748,0.0,4.99,95124.9,CRED CREA,Despesas financeiras,Outras,../data/raw/BANCO CRED CREA - 2023.xlsx
2023-10-05,DEBITO PIX - ANTONIO ODENIR FERRAZ - PAGTO 2ª PARTE RANGER,304872748,0.0,95000.0,124.9,CRED CREA,Despesas administrativas,Veiculos,../data/raw/BANCO CRED CREA - 2023.xlsx
2023-10-06,CREDITO TED - PAGSEGURO INTERNET LTDA,33002158,1272.31,0.0,1397.21,CRED CREA,Receita com serviços,Outras,../data/raw/BANCO CRED CREA - 2023.xlsx
2023-10-09,CREDITO TED - PAGSEGURO INTERNET LTDA,34290591,685.59,0.0,2082.8,CRED CREA,Receita com serviços,Outras,../data/raw/BANCO CRED CREA - 2023.xlsx
2023-10-10,DB. ALLIANZ - SEGURO SPIN 3 DE 10,84624000166,0.0,184.61,1898.19,CRED CREA,Despesas administrativas,Seguro veicular,../data/raw/BANCO CRED CREA - 2023.xlsx
2023-10-11,CREDITO TED - PAGSEGURO INTERNET LTDA,34379462,1342.52,0.0,3240.71,CRED CREA,Receita com serviços,Outras,../data/raw/BANCO CRED CREA - 2023.xlsx
2023-10-16,DB. COTAS,19911,0.0,69.5,3171.21,CRED CREA,Despesas financeiras,Outras,../data/raw/BANCO CRED CREA - 2023.xlsx
2023-10-16,DB. ALLIANZ - SEGURO RANGER  DE E DE 9,84624000166,0.0,219.08,2952.13,CRED CREA,Despesas administrativas,Seguro veicular,../data/raw/BANCO CRED CREA - 2023.xlsx
2023-10-19,CREDITO TED - PAGSEGURO INTERNET LTDA,34209432,841.65,0.0,3793.78,CRED CREA,Receita com serviços,Outras,../data/raw/BANCO CRED CREA - 2023.xlsx
2023-10-20,CREDITO TED - PAGSEGURO INTERNET LTDA,34458461,987.75,0.0,4781.53,CRED CREA,Receita com serviços,Outras,../data/raw/BANCO CRED CREA - 2023.xlsx
2023-10-24,CREDITO TED - PAGSEGURO INTERNET LTDA,33830056,431.29,0.0,5212.82,CRED CREA,Receita com serviços,Outras,../data/raw/BANCO CRED CREA - 2023.xlsx
2023-10-24,PG.P/INTERNET - LIGGA TELECOM,10002417,0.0,149.9,5062.92,CRED CREA,Despesas administrativas,"Telefonia (Celular, Fixo, Internet)",../data/raw/BANCO CRED CREA - 2023.xlsx
2023-10-24,PG.P/INTERNET - NET FONE,10002429,0.0,136.0,4926.92,CRED CREA,Despesas administrativas,"Telefonia (Celular, Fixo, Internet)",../data/raw/BANCO CRED CREA - 2023.xlsx
2023-10-24,PG.P/INTERNET - CELULAR,10002549,0.0,64.54,4862.38,CRED CREA,Despesas administrativas,"Telefonia (Celular, Fixo, Internet)",../data/raw/BANCO CRED CREA - 2023.xlsx
2023-10-24,PG.P/INTERNET - MED CURITIBA,10002558,0.0,111.45,4750.93,CRED CREA,Despesa com pessoal,Assistência médica,../data/raw/BANCO CRED CREA - 2023.xlsx
2023-10-31,CREDITO TED - PAGSEGURO INTERNET LTDA,34169369,392.65,0.0,5143.58,CRED CREA,Receita com serviços,Outras,../data/raw/BANCO CRED CREA - 2023.xlsx
2023-10-31,PG.P/INTERNET - VR BENEFICIOS E SERV. DE PROC.,10003446,0.0,1600.0,3543.58,CRED CREA,Despesa com pessoal,Alimentação (VR VA),../data/raw/BANCO CRED CREA - 2023.xlsx
2023-11-03,CREDITO TED - PAGSEGURO INTERNET LTDA,34538423,1173.36,0.0,4716.94,CRED CREA,Receita com serviços,Outras,../data/raw/BANCO CRED CREA - 2023.xlsx
2023-11-03,PG.P/INTERNET - CONTA DE AGUA,10004966,0.0,204.88,4512.06,CRED CREA,Despesas administrativas,Água,../data/raw/BANCO CRED CREA - 2023.xlsx
2023-11-07,CREDITO TED - PAGSEGURO INTERNET LTDA,33011666,1617.22,0.0,6129.28,CRED CREA,Receita com serviços,Outras,../data/raw/BANCO CRED CREA - 2023.xlsx
2023-11-08,CREDITO TED - PAGSEGURO INTERNET LTDA,34143501,1255.3,0.0,7384.58,CRED CREA,Receita com serviços,Outras,../data/raw/BANCO CRED CREA - 2023.xlsx
2023-11-08,PG.P/INTERNET - ALUGUEL,10003285,0.0,4707.97,2676.61,CRED CREA,Despesas administrativas,Aluguel imóvel,../data/raw/BANCO CRED CREA - 2023.xlsx
2023-11-09,CREDITO TED - PAGSEGURO INTERNET LTDA,33944258,2178.74,0.0,4855.35,CRED CREA,Receita com serviços,Outras,../data/raw/BANCO CRED CREA - 2023.xlsx
2023-11-10,PREST.EMPREST 001/048,5,0.0,2460.29,2395.06,CRED CREA,Despesas financeiras,Outras,../data/raw/BANCO CRED CREA - 2023.xlsx
2023-11-10,DB. ALLIANZ  SEGURO RANGER  DE 4 DE 10,84624000166,0.0,184.61,2210.45,CRED CREA,Despesas administrativas,Seguro veicular,../data/raw/BANCO CRED CREA - 2023.xlsx
2023-11-10,DB. ALLIANZ  SEGURO RANGER  DE 2 DE 09,46240001660,0.0,219.08,1991.37,CRED CREA,Despesas administrativas,Seguro veicular,../data/raw/BANCO CRED CREA - 2023.xlsx
2023-11-10,CREDITO TED - PAGSEGURO INTERNET LTDA,34501625,592.31,0.0,2583.68,CRED CREA,Receita com serviços,Outras,../data/raw/BANCO CRED CREA - 2023.xlsx
2023-11-14,PG.P/INTERNET - PARANA CLINICAS - PLANOS DE SAUDE,10005086,0.0,895.72,1687.96,CRED CREA,Despesa com pessoal,Assistência médica,../data/raw/BANCO CRED CREA - 2023.xlsx
2023-11-16,DB. COTAS,19911,0.0,69.5,1618.46,CRED CREA,Despesas financeiras,Outras,../data/raw/BANCO CRED CREA - 2023.xlsx
2023-11-16,CREDITO TED - PAGSEGURO INTERNET LTDA,34731352,720.88,0.0,2339.34,CRED CREA,Receita com serviços,Outras,../data/raw/BANCO CRED CREA - 2023.xlsx
2023-11-16,PG.P/INTERNET - ENERGIA LJ 3,10007338,0.0,137.33,2202.01,CRED CREA,Despesas administrativas,Energia,../data/raw/BANCO CRED CREA - 2023.xlsx
2023-11-16,PG.P/INTERNET - ENERGIA LJ 4,10007416,0.0,56.38,2145.63,CRED CREA,Despesas administrativas,Energia,../data/raw/BANCO CRED CREA - 2023.xlsx
2023-11-16,PG.P/INTERNET - ENERGIA LJ 6,10007435,0.0,395.83,1749.8,CRED CREA,Despesas administrativas,Energia,../data/raw/BANCO CRED CREA - 2023.xlsx
2023-11-17,CREDITO TED - PAGSEGURO INTERNET LTDA,34622115,878.77,0.0,2628.57,CRED CREA,Receita com serviços,Outras,../data/raw/BANCO CRED CREA - 2023.xlsx
2023-11-21,CREDITO TED - PAGSEGURO INTERNET LTDA,34258693,785.67,0.0,3414.24,CRED CREA,Receita com serviços,Outras,../data/raw/BANCO CRED CREA - 2023.xlsx
2023-11-22,CREDITO TED - PAGSEGURO INTERNET LTDA,34060178,2069.36,0.0,5483.6,CRED CREA,Receita com serviços,Outras,../data/raw/BANCO CRED CREA - 2023.xlsx
2023-11-24,PG.P/INTERNET - LIGGA TELECOM,10002456,0.0,149.9,5333.7,CRED CREA,Despesas administrativas,"Telefonia (Celular, Fixo, Internet)",../data/raw/BANCO CRED CREA - 2023.xlsx
2023-11-24,PG.P/INTERNET - NET FONE,10002468,0.0,136.85,5196.85,CRED CREA,Despesas administrativas,"Telefonia (Celular, Fixo, Internet)",../data/raw/BANCO CRED CREA - 2023.xlsx
2023-11-24,PG.P/INTERNET - CELULAR,10002488,0.0,64.54,5132.31,CRED CREA,Despesas administrativas,"Telefonia (Celular, Fixo, Internet)",../data/raw/BANCO CRED CREA - 2023.xlsx
2023-11-24,PG.P/INTERNET - MED CURITIBA,10002517,0.0,105.45,5026.86,CRED CREA,Despesa com pessoal,Assistência médica,../data/raw/BANCO CRED CREA - 2023.xlsx
2023-11-24,CREDITO TED - PAGSEGURO INTERNET LTDA,34003122,1081.92,0.0,6108.78,CRED CREA,Receita com serviços,Outras,../data/raw/BANCO CRED CREA - 2023.xlsx
2023-11-28,CREDITO TED - PAGSEGURO INTERNET LTDA,33986810,1562.47,0.0,7671.25,CRED CREA,Receita com serviços,Outras,../data/raw/BANCO CRED CREA - 2023.xlsx
2023-11-29,PG.P/INTERNET - VT CINTHYA E BRENDA,10001013,0.0,483.03,7188.22,CRED CREA,Despesa com pessoal,Transporte (VT),../data/raw/BANCO CRED CREA - 2023.xlsx
2023-11-30,PG.P/INTERNET - VR BENEFICIOS E SERV. DE PROC.,10002775,0.0,1700.0,5488.22,CRED CREA,Despesa com pessoal,Alimentação (VR VA),../data/raw/BANCO CRED CREA - 2023.xlsx
2023-12-01,PG.P/INTERNET - SPRINGER CARRIER,10005252,0.0,198.6,5289.62,CRED CREA,Despesa com produtos,Outras,../data/raw/BANCO CRED CREA - 2023.xlsx
2023-12-01,PG.P/INTERNET - SELETROAR - PARCELA 4 DE 5,10005266,0.0,92.79,5196.83,CRED CREA,Despesa com produtos,Outras,../data/raw/BANCO CRED CREA - 2023.xlsx
2023-12-04,CREDITO TED - PAGSEGURO INTERNET LTDA,34491933,431.29,0.0,5628.12,CRED CREA,Receita com serviços,Outras,../data/raw/BANCO CRED CREA - 2023.xlsx
2023-12-04,PG.P/INTERNET - GRPR (GNRE GUIA ESTADUAL),10006164,0.0,285.13,5342.99,CRED CREA,Despesas tributárias ,Outras,../data/raw/BANCO CRED CREA - 2023.xlsx
2023-12-04,PG.P/INTERNET - CONTA DE AGUA,10006201,0.0,267.2,5075.79,CRED CREA,Despesas administrativas,Água,../data/raw/BANCO CRED CREA - 2023.xlsx
2023-12-04,PG.P/INTERNET - WHITE MARTINS,10006232,0.0,150.34,4925.45,CRED CREA,Despesa com produtos,Materiais de Consumo,../data/raw/BANCO CRED CREA - 2023.xlsx
2023-12-06,PIX TRANSF PAGADOR,335786268,0.0,2.8,4922.65,CRED CREA,Despesa com produtos,Outras,../data/raw/BANCO CRED CREA - 2023.xlsx
2023-12-06,DEBITO PIX - Nicolas Falavinha Christino,335786268,0.0,932.65,3990,CRED CREA,Despesa com produtos,Outras,../data/raw/BANCO CRED CREA - 2023.xlsx
2023-12-07,PG.P/INTERNET - FGTS,10005613,0.0,1359.02,2630.98,CRED CREA,Despesa com pessoal,FGTS,../data/raw/BANCO CRED CREA - 2023.xlsx
2023-12-08,CR.APL.RDCPOS - RESGATE DE APLICAÇÕES,99,10000.0,0.0,12630.98,CRED CREA,Receitas financeiras,Outras,../data/raw/BANCO CRED CREA - 2023.xlsx
2023-12-08,CREDITO TED - PAGSEGURO INTERNET LTDA,34215373,855.23,0.0,13486.21,CRED CREA,Receita com serviços,Outras,../data/raw/BANCO CRED CREA - 2023.xlsx
2023-12-08,PG.P/INTERNET - ALUGUEL,10004915,0.0,4707.97,8778.24,CRED CREA,Despesas administrativas,Aluguel imóvel,../data/raw/BANCO CRED CREA - 2023.xlsx
2023-12-08,DEBITO PIX - Elisabete Seolin Galindo - PAGTO PRO-LABORE,337846340,0.0,1335.0,7443.24,CRED CREA,Despesa com pessoal,Pró labore,../data/raw/BANCO CRED CREA - 2023.xlsx
2023-12-08,PIX TRANSF PAGADOR,337846340,0.0,4.0,7439.24,CRED CREA,Despesa com produtos,Outras,../data/raw/BANCO CRED CREA - 2023.xlsx
2023-12-08,PIX TRANSF PAGADOR,337848723,0.0,4.0,7435.24,CRED CREA,Despesa com produtos,Outras,../data/raw/BANCO CRED CREA - 2023.xlsx
2023-12-08,DEBITO PIX - Claudio Vinicius Galindo - PAGTO PRO-LABORE,337848723,0.0,1335.0,6100.24,CRED CREA,Despesa com pessoal,Pró labore,../data/raw/BANCO CRED CREA - 2023.xlsx
2023-12-08,PG.P/INTERNET - PAGTO ESTAGIARIOS,10005271,0.0,925.38,5174.86,CRED CREA,Despesa com pessoal,13º salário,../data/raw/BANCO CRED CREA - 2023.xlsx
2023-12-11,PREST.EMPREST 002/048,3,0.0,2460.29,2714.57,CRED CREA,Despesas financeiras,Outras,../data/raw/BANCO CRED CREA - 2023.xlsx
2023-12-11,DB. ALLIANZ SEGURO RANGER  DE 5 DE 10,84624000166,0.0,184.61,2529.96,CRED CREA,Despesas administrativas,Seguro veicular,../data/raw/BANCO CRED CREA - 2023.xlsx
2023-12-11,DB. ALLIANZ SEGURO RANGER  DE 3 DE 09,46240001660,0.0,219.08,2310.88,CRED CREA,Despesas administrativas,Seguro veicular,../data/raw/BANCO CRED CREA - 2023.xlsx
2023-12-11,CREDITO TED - PAGSEGURO INTERNET LTDA,34384375,423.55,0.0,2734.43,CRED CREA,Receita com serviços,Outras,../data/raw/BANCO CRED CREA - 2023.xlsx
2023-12-11,PG.P/INTERNET - SPRINGER CARRIER,10009882,0.0,371.29,2363.14,CRED CREA,Despesa com produtos,Outras,../data/raw/BANCO CRED CREA - 2023.xlsx
2023-12-11,PG.P/INTERNET - WHITE MARTINS,10009953,0.0,39.76,2323.38,CRED CREA,Despesa com produtos,Materiais de Consumo,../data/raw/BANCO CRED CREA - 2023.xlsx
2023-12-12,PG.P/INTERNET - FRESNOMAQ INDUSTRIA DE MAQUINA (WAP),10001689,0.0,153.98,2169.4,CRED CREA,Despesa com produtos,Outras,../data/raw/BANCO CRED CREA - 2023.xlsx
2023-12-13,CREDITO TED - PAGSEGURO INTERNET LTDA,34187505,4580.06,0.0,6749.46,CRED CREA,Receita com serviços,Outras,../data/raw/BANCO CRED CREA - 2023.xlsx
2023-12-14,PG.P/INTERNET - CARTAO AMERICAN,10002823,0.0,2910.74,3838.72,CRED CREA,Despesa com produtos,Outras,../data/raw/BANCO CRED CREA - 2023.xlsx
2023-12-14,PG.P/INTERNET - ENERGIA LJ 3,10002838,0.0,176.16,3662.56,CRED CREA,Despesas administrativas,Energia,../data/raw/BANCO CRED CREA - 2023.xlsx
2023-12-14,PG.P/INTERNET - ENERGIA LJ 4,10002853,0.0,62.7,3599.86,CRED CREA,Despesas administrativas,Energia,../data/raw/BANCO CRED CREA - 2023.xlsx
2023-12-14,PG.P/INTERNET - ENERGIA LJ 6,10002862,0.0,423.9,3175.96,CRED CREA,Despesas administrativas,Energia,../data/raw/BANCO CRED CREA - 2023.xlsx
2023-12-14,PG.P/INTERNET - SPRINGER CARRIER,10002878,0.0,11.46,3164.5,CRED CREA,Despesa com produtos,Outras,../data/raw/BANCO CRED CREA - 2023.xlsx
2023-12-14,PG.P/INTERNET - PARANA CLINICAS - PLANOS DE SA,10002894,0.0,895.72,2268.78,CRED CREA,Despesa com pessoal,Assistência médica,../data/raw/BANCO CRED CREA - 2023.xlsx
2023-12-14,PG.P/INTERNET - PARANA CLINICAS - PLANOS DE SA,10002910,0.0,148.52,2120.26,CRED CREA,Despesa com pessoal,Assistência médica,../data/raw/BANCO CRED CREA - 2023.xlsx
2023-12-15,DB. COTAS,19911,0.0,69.5,2050.76,CRED CREA,Despesas financeiras,Outras,../data/raw/BANCO CRED CREA - 2023.xlsx
2023-12-15,CREDITO TED - PAGSEGURO INTERNET LTDA,34340855,474.92,0.0,2525.68,CRED CREA,Receita com serviços,Outras,../data/raw/BANCO CRED CREA - 2023.xlsx
2023-12-18,CREDITO TED - PAGSEGURO INTERNET LTDA,34550609,624.51,0.0,3150.19,CRED CREA,Receita com serviços,Outras,../data/raw/BANCO CRED CREA - 2023.xlsx
2023-12-19,CR.APL.RDCPOS,130,12839.93,0.0,15990.12,CRED CREA,Receitas financeiras,Outras,../data/raw/BANCO CRED CREA - 2023.xlsx
2023-12-19,CR.APL.RDCPOS,131,1791.32,0.0,17781.44,CRED CREA,Receitas financeiras,Outras,../data/raw/BANCO CRED CREA - 2023.xlsx
2023-12-19,PIX TRANSF PAGADOR,344226945,0.0,4.99,17776.45,CRED CREA,Despesa com produtos,Outras,../data/raw/BANCO CRED CREA - 2023.xlsx
2023-12-19,DEBITO PIX - TATYANA TAMYRES DA SILVA CHAVIER - RESCISÃO,344226945,0.0,6296.71,11479.74,CRED CREA,Despesa com pessoal,Aviso prévio / Multa rescisória,../data/raw/BANCO CRED CREA - 2023.xlsx
2023-12-20,PG.P/INTERNET - FGTS RESCISAO TATYANA,10002768,0.0,2543.57,8936.17,CRED CREA,Despesa com pessoal,FGTS,../data/raw/BANCO CRED CREA - 2023.xlsx
2023-12-20,PG.P/INTERNET - DARF - INSS,10002901,0.0,1294.66,7641.51,CRED CREA,Despesa com pessoal,INSS,../data/raw/BANCO CRED CREA - 2023.xlsx
2023-12-20,PG.P/INTERNET - DARF - DECIMO TERCEIRO SALARIO,10002965,0.0,568.76,7072.75,CRED CREA,Despesa com pessoal,13º salário,../data/raw/BANCO CRED CREA - 2023.xlsx
2023-12-20,PG.P/INTERNET - DARF REF ALUGUEL,10002997,0.0,84.58,6988.17,CRED CREA,Despesas administrativas,Aluguel imóvel,../data/raw/BANCO CRED CREA - 2023.xlsx
2023-12-20,PG.P/INTERNET - DAS - SIMPLES NACIONAL,10003044,0.0,2409.25,4578.92,CRED CREA,Despesas tributárias ,Outras,../data/raw/BANCO CRED CREA - 2023.xlsx
2023-12-21,CREDITO TED - PAGSEGURO INTERNET LTDA,34231336,469.68,0.0,5048.6,CRED CREA,Receita com serviços,Outras,../data/raw/BANCO CRED CREA - 2023.xlsx
2023-12-22,CREDITO TED - PAGSEGURO INTERNET LTDA,34282466,573.42,0.0,5622.02,CRED CREA,Receita com serviços,Outras,../data/raw/BANCO CRED CREA - 2023.xlsx
2023-12-22,PG.P/INTERNET - MED CURITIBA,10004951,0.0,115.99,5506.03,CRED CREA,Despesa com pessoal,Assistência médica,../data/raw/BANCO CRED CREA - 2023.xlsx
2023-12-22,PG.P/INTERNET - PACKPAR EMBALAGENS EIRELI,10004956,0.0,377.0,5129.03,CRED CREA,Despesa com produtos,Materiais de Consumo,../data/raw/BANCO CRED CREA - 2023.xlsx
2023-12-26,PG.P/INTERNET - CELULAR,10002740,0.0,64.54,5064.49,CRED CREA,Despesas administrativas,"Telefonia (Celular, Fixo, Internet)",../data/raw/BANCO CRED CREA - 2023.xlsx
2023-12-26,PG.P/INTERNET - LIGGA TELECOM,10002741,0.0,149.9,4914.59,CRED CREA,Despesas administrativas,"Telefonia (Celular, Fixo, Internet)",../data/raw/BANCO CRED CREA - 2023.xlsx
2023-12-26,PG.P/INTERNET - NET FONE,,0.0,136.0,4778.59,CRED CREA,Despesas administrativas,"Telefonia (Celular, Fixo, Internet)",../data/raw/BANCO CRED CREA - 2023.xlsx
2023-12-27,CREDITO TED - PAGSEGURO INTERNET LTDA,,736.47,0.0,5515.06,CRED CREA,Receita com serviços,Outras,../data/raw/BANCO CRED CREA - 2023.xlsx
2023-12-28,CREDITO TED - PAGSEGURO INTERNET LTDA,,1374.44,0.0,6889.5,CRED CREA,Receita com serviços,Outras,../data/raw/BANCO CRED CREA - 2023.xlsx
2023-12-28,PG.P/INTERNET - VALE TRANSPORTE BENDA E RONALDO,,0.0,381.03,6508.47,CRED CREA,Despesa com pessoal,Transporte (VT),../data/raw/BANCO CRED CREA - 2023.xlsx
2023-12-28,PG.P/INTERNET - VR BENEFICIOS E SERV. DE PROC.,,0.0,1850.0,4658.47,CRED CREA,Despesa com pessoal,Alimentação (VR VA),../data/raw/BANCO CRED CREA - 2023.xlsx
2022-01-03,PIX RECEBIDO RENATA CRISTINA LIDIO GREIN,,135.0,0.0,11006.52,INTER,Receita com serviços,Outras,../data/raw/BANCO INTER-2022.xlsx
2022-01-03,PIX RECEBIDO PRISCILLA DAYANE SANTOS,,250.0,0.0,11256.52,INTER,Receita com serviços,Outras,../data/raw/BANCO INTER-2022.xlsx
2022-01-03,PIX RECEBIDO ANA LÚCIA DE ALMEIDA SAMPAIO SUZUKI,,220.0,0.0,11476.52,INTER,Receita com serviços,Outras,../data/raw/BANCO INTER-2022.xlsx
2022-01-03,PIX ENVIADO -PIX MARKETPLACE,,0.0,200.3,11276.22,INTER,Despesa com serviços,Outras,../data/raw/BANCO INTER-2022.xlsx
2022-01-04,PIX RECEBIDO MADALENA GERALDO DA SILVA MAIA,,250.0,0.0,11526.22,INTER,Receita com serviços,Outras,../data/raw/BANCO INTER-2022.xlsx
2022-01-04,PIX RECEBIDO ANDRE LUIS DA SILVA TEIXEIRA,,250.0,0.0,11776.22,INTER,Receita com serviços,Outras,../data/raw/BANCO INTER-2022.xlsx
2022-01-05,PIX ENVIADO  FACI.LY SOLUCOES E TECNOLOGIA LTDA.,,0.0,14.97,11761.25,INTER,Despesa com serviços,Outras,../data/raw/BANCO INTER-2022.xlsx
2022-01-05,PIX ENVIADO FACI.LY SOLUCOES E TECNOLOGIA LTDA.,,0.0,23.97,11737.28,INTER,Despesa com serviços,Outras,../data/raw/BANCO INTER-2022.xlsx
2022-01-05,PIX RECEBIDO FELIPE PEDROSO H MELO LACERDA,,70.0,0.0,11807.28,INTER,Receita com serviços,Outras,../data/raw/BANCO INTER-2022.xlsx
2022-01-05,COMPRA CARTÃO  OXIMILLE CURITIBA - ,,0.0,215.0,11592.28,INTER,Despesa com produtos,Outras,../data/raw/BANCO INTER-2022.xlsx
2022-01-05,PIX ENVIADO GOVERNO DO PARANA SECRETARIA DE ESTADO-GRPR,,0.0,138.31,11453.97,INTER,Despesas tributárias ,Outras,../data/raw/BANCO INTER-2022.xlsx
2022-01-06,PIX RECEBIDO SIMONE YAMAGUCHI,,280.0,0.0,11733.97,INTER,Receita com serviços,Outras,../data/raw/BANCO INTER-2022.xlsx
2022-01-07,COMPRA CARTÃO  PAG*CIALATINO – 2 TESTES DE COVID (BETE E CLAUDIO),,0.0,178.0,11555.97,INTER,Despesa com pessoal,Outras,../data/raw/BANCO INTER-2022.xlsx
2022-01-07,PIX RECEBIDO CATIA FABIANE COQUI,,211.0,0.0,11766.97,INTER,Receita com serviços,Outras,../data/raw/BANCO INTER-2022.xlsx
2022-01-07,PIX RECEBIDO LUCILLE HAQUIM,,90.0,0.0,11856.97,INTER,Receita com serviços,Outras,../data/raw/BANCO INTER-2022.xlsx
2022-01-07,PIX ENVIADO TATYANA CHAVIER -PAGTO DE SALÁRIO,,0.0,969.19,10887.78,INTER,Despesa com pessoal,Salário,../data/raw/BANCO INTER-2022.xlsx
2022-01-07,PIX ENVIADO GUILHERME FILIPE ROMPAVA -PAGTO DE SALÁRIO,,0.0,935.72,9952.06,INTER,Despesa com pessoal,Salário,../data/raw/BANCO INTER-2022.xlsx
2022-01-07,PIX ENVIADO FERNANDA MARQUES CARBONE -PAGTO DE SALÁRIO,,0.0,871.76,9080.3,INTER,Despesa com pessoal,Salário,../data/raw/BANCO INTER-2022.xlsx
2022-01-07,PIX ENVIADO CARLOS EDUARDO TOCHETTO -PAGTO DE SALÁRIO,,0.0,1613.68,7466.62,INTER,Despesa com pessoal,Salário,../data/raw/BANCO INTER-2022.xlsx
2022-01-07,PIX ENVIADO MATHEUS CARDOSO VIEIRA -PAGTO DE SALÁRIO,,0.0,969.19,6497.43,INTER,Despesa com pessoal,Salário,../data/raw/BANCO INTER-2022.xlsx
2022-01-07,PIX ENVIADO FERNANDA MARQUES P/ PAGTO  TESTE DE COVID,,0.0,89.0,6408.43,INTER,Despesa com pessoal,Outras,../data/raw/BANCO INTER-2022.xlsx
2022-01-10,PIX RECEBIDO CAROLINE DE OLIVEIRA BERTOLINO,,40.0,0.0,6448.43,INTER,Receita com serviços,Outras,../data/raw/BANCO INTER-2022.xlsx
2022-01-10,PIX RECEBIDO IVANA VELOSO LEANDRO DE AS,,65.0,0.0,6513.43,INTER,Receita com serviços,Outras,../data/raw/BANCO INTER-2022.xlsx
2022-01-10,PAGAMENTO BOLETO VT LUIZ,,0.0,209.63,6303.8,INTER,Despesa com pessoal,Transporte (VT),../data/raw/BANCO INTER-2022.xlsx
2022-01-10,PIX ENVIADO ELISABETE SEOLIN GALINDO PRO-LABORE,,0.0,979.0,5324.8,INTER,Despesa com pessoal,Pró labore,../data/raw/BANCO INTER-2022.xlsx
2022-01-10,PIX ENVIADO CLAUDIO VINICIUS GALINDO PRO-LABORE,,0.0,979.0,4345.8,INTER,Despesa com pessoal,Pró labore,../data/raw/BANCO INTER-2022.xlsx
2022-01-11,PIX RECEBIDO PATRICIA FERREIRA MONTICELLI,,330.0,0.0,4675.8,INTER,Receita com serviços,Outras,../data/raw/BANCO INTER-2022.xlsx
2022-01-11,PIX RECEBIDO CRISTIANO ROLIM PEREIRA,,600.0,0.0,5275.8,INTER,Receita com serviços,Outras,../data/raw/BANCO INTER-2022.xlsx
2022-01-11,PIX RECEBIDO FABIO RODRIGO BURKOT,,75.0,0.0,5350.8,INTER,Receita com serviços,Outras,../data/raw/BANCO INTER-2022.xlsx
2022-01-12,PIX RECEBIDO NEVIO CAVASIN,,260.0,0.0,5610.8,INTER,Receita com serviços,Outras,../data/raw/BANCO INTER-2022.xlsx
2022-01-13,PIX RECEBIDO OSMAR GOMES,,500.0,0.0,6110.8,INTER,Receita com serviços,Outras,../data/raw/BANCO INTER-2022.xlsx
2022-01-13,PIX RECEBIDO DANIEL SOUTO DE MORAES,,375.0,0.0,6485.8,INTER,Receita com serviços,Outras,../data/raw/BANCO INTER-2022.xlsx
2022-01-14,PIX RECEBIDO VITOR SILVA PAIVA,,38.0,0.0,6523.8,INTER,Receita com serviços,Outras,../data/raw/BANCO INTER-2022.xlsx
2022-01-17,COMPRA CARTAO  NOVA ESTANCIA REST CURITIBA - AT. ON-SITE PANASONIC,,0.0,44.0,6479.8,INTER,Despesa com produtos,Outras,../data/raw/BANCO INTER-2022.xlsx
2022-01-17,PIX RECEBIDO STELLA GEMIN,,150.0,0.0,6629.8,INTER,Receita com serviços,Outras,../data/raw/BANCO INTER-2022.xlsx
2022-01-17,PIX ENVIADO ANDREZA DO CARMO PEREIRA MELO - DEV. DE PIX 20/12/21,,0.0,200.0,6429.8,INTER,Transferência (Débito),Transferência / Reembolso,../data/raw/BANCO INTER-2022.xlsx
2022-01-17,COMPRA CARTÃO STAMPAFER CURITIBA - NF 18717-28/01/22,,0.0,330.0,6099.8,INTER,Despesa com produtos,Outras,../data/raw/BANCO INTER-2022.xlsx
2022-01-19,PIX RECEBIDO KURT WERNER REICHENBACH,,600.0,0.0,9699.8,INTER,Receita com serviços,Outras,../data/raw/BANCO INTER-2022.xlsx
2022-01-19,COMPRA CARTÃO FRIGELAR COM E INDUSTR - NF 70.429,,0.0,107.1,6592.7,INTER,Despesa com produtos,Outras,../data/raw/BANCO INTER-2022.xlsx
2022-01-20,PIX ENVIADO GOVERNO DO PR - IPVA-2022 - SPIN,,0.0,1627.6,4965.1,INTER,Despesas tributárias ,IPVA,../data/raw/BANCO INTER-2022.xlsx
2022-01-20,PIX RECEBIDO SANDRA CRISTINE ALLE SANTOS,,553.0,0.0,5518.1,INTER,Receita com serviços,Outras,../data/raw/BANCO INTER-2022.xlsx
2022-01-20,PIX ENVIADO GOVERNO DO PR - IPVA-2022 - MOTO,,0.0,191.91,5326.19,INTER,Despesas tributárias ,IPVA,../data/raw/BANCO INTER-2022.xlsx
2022-01-21,COMPRA CARTÃO VILA IZABEL MATERIAIS CONSTRUÇÃO,,0.0,39.0,5287.19,INTER,Despesas administrativas,Manutenção predial,../data/raw/BANCO INTER-2022.xlsx
2022-01-21,PIX RECEBIDO DIEIME JOANA P IZUMI,,600.0,0.0,5887.19,INTER,Receita com serviços,Outras,../data/raw/BANCO INTER-2022.xlsx
2022-01-21,CASHBACK CARTÃO DE CRÉDITO,,3.91,0.0,5891.1,INTER,Receitas financeiras,Outras,../data/raw/BANCO INTER-2022.xlsx
2022-01-24,PIX RECEBIDO MARLEI MARQUES RIUL,,220.0,0.0,6111.1,INTER,Receita com serviços,Outras,../data/raw/BANCO INTER-2022.xlsx
2022-01-24,PIX RECEBIDO YURI NEVES GAZEN,,410.0,0.0,6521.1,INTER,Receita com serviços,Outras,../data/raw/BANCO INTER-2022.xlsx
2022-01-24,PIX RECEBIDO SANDRA CRISTINE ALLE SANTOS,,500.0,0.0,7021.1,INTER,Receita com serviços,Outras,../data/raw/BANCO INTER-2022.xlsx
2022-01-25,PIX ENVIADO SANDRA CRISTINE ALLE SANTOS - DEV. DE PIX 24/01/22,,0.0,250.0,6771.1,INTER,Transferência (Débito),Transferência / Reembolso,../data/raw/BANCO INTER-2022.xlsx
2022-01-25,PIX RECEBIDO SANDRINEIA RUFINO DA CRUZ,,300.0,0.0,7071.1,INTER,Receita com serviços,Outras,../data/raw/BANCO INTER-2022.xlsx
2022-01-25,PIX RECEBIDO ADRIANA RAMOS DA CUNHA,,120.0,0.0,7191.1,INTER,Receita com serviços,Outras,../data/raw/BANCO INTER-2022.xlsx
2022-01-26,PIX RECEBIDO RICARDO ARAUJO PORCHAT DE LEAO,,250.0,0.0,7441.1,INTER,Receita com serviços,Outras,../data/raw/BANCO INTER-2022.xlsx
2022-01-26,PIX RECEBIDO BRUNO SIROT ALMEIDA EICHLER,,60.0,0.0,7501.1,INTER,Receita com serviços,Outras,../data/raw/BANCO INTER-2022.xlsx
2022-01-26,PIX RECEBIDO IVAN LUCAS DE OLIVEIRA,,500.0,0.0,8001.1,INTER,Receita com serviços,Outras,../data/raw/BANCO INTER-2022.xlsx
2022-01-26,COMPRA CARTÃO SUBWAY BATEL CURITIBA,,0.0,89.0,7912.1,INTER,Despesa com produtos,Outras,../data/raw/BANCO INTER-2022.xlsx
2022-01-26,COMPRA CARTÃO FARMACIA IRMAOS PAVESI,,0.0,102.41,7809.69,INTER,Despesa com produtos,Outras,../data/raw/BANCO INTER-2022.xlsx
2022-01-27,PIX RECEBIDO MARIANA MIKA FUJIMURA,,285.0,0.0,8094.69,INTER,Receita com serviços,Outras,../data/raw/BANCO INTER-2022.xlsx
2022-01-27,PIX RECEBIDO FERNANDO FERREIRA TRANSPORTES,,600.0,0.0,8694.69,INTER,Receita com serviços,Outras,../data/raw/BANCO INTER-2022.xlsx
2022-01-27,PIX RECEBIDO ALESSANDRO B DE CARVALHO,,130.0,0.0,8824.69,INTER,Receita com serviços,Outras,../data/raw/BANCO INTER-2022.xlsx
2022-01-28,PIX RECEBIDO JUAN PABLO AGUERO,,50.0,0.0,8874.69,INTER,Receita com serviços,Outras,../data/raw/BANCO INTER-2022.xlsx
2022-01-28,PIX ENVIADO MEGA AR STORE NF 1102,,0.0,140.65,8734.04,INTER,Despesa com serviços,Outras,../data/raw/BANCO INTER-2022.xlsx
2022-01-28,PIX ENVIADO CARLOS - PAGTO REF. NF 3626,,0.0,1661.8,7072.24,INTER,Despesa com serviços,Outras,../data/raw/BANCO INTER-2022.xlsx
2022-01-28,PIX RECEBIDO TANIA COIFMAN BERGMAN,,37.5,0.0,7109.74,INTER,Receita com serviços,Outras,../data/raw/BANCO INTER-2022.xlsx
2022-01-28,PIX ENVIADO LUAN - PAGTO DE COMBUSTÍVEL MOTO,,0.0,63.0,7046.74,INTER,Despesas administrativas,Combustivel,../data/raw/BANCO INTER-2022.xlsx
2022-01-31,PIX ENVIADO XI ZHANG - MANTA DE EVA,,0.0,120.0,6926.74,INTER,Despesa com produtos,Materiais de Consumo,../data/raw/BANCO INTER-2022.xlsx
2022-01-31,PIX RECEBIDO CARLA REGINA RODRIGUES,,220.0,0.0,7146.74,INTER,Receita com serviços,Outras,../data/raw/BANCO INTER-2022.xlsx
2022-01-31,PIX RECEBIDO MARLI APARECIDA DIAS,,180.0,0.0,7326.74,INTER,Receita com serviços,Outras,../data/raw/BANCO INTER-2022.xlsx
2022-02-01,PIX ENVIADO CARLOS E. TOCHETTO - COMPRA MAT. ESCRIT. NA CONTABILISTA,,0.0,92.75,,INTER,Despesas administrativas,Contabilidade,../data/raw/BANCO INTER-2022.xlsx
2022-02-01,PIX RECEBIDO ADRIANA CRISTINA DA SILVA,,129.24,0.0,,INTER,Receita com serviços,Outras,../data/raw/BANCO INTER-2022.xlsx
2022-02-01,COMPRA CARTÃO LEROY MERLIN NFC-e 9221,,0.0,179.28,7183.95,INTER,Despesa com produtos,Outras,../data/raw/BANCO INTER-2022.xlsx
2022-02-02,COMPRA CARTÃO ACTOS CURITIBA NF 169090,,0.0,200.0,,INTER,Despesa com produtos,Outras,../data/raw/BANCO INTER-2022.xlsx
2022-02-02,PIX RECEBIDO CIBELLE KARINA PIMENTA,,100.0,0.0,7083.95,INTER,Receita com serviços,Outras,../data/raw/BANCO INTER-2022.xlsx
2022-02-03,COMPRA CARTÃO THUNDERBULL PINHAIS,,0.0,42.5,7041.45,INTER,Despesa com produtos,Outras,../data/raw/BANCO INTER-2022.xlsx
2022-02-04,PIX RECEBIDO FERNANDO AUGUSTO MONTA,,245.0,0.0,7286.45,INTER,Receita com serviços,Outras,../data/raw/BANCO INTER-2022.xlsx
2022-02-04,PIX ENVIADO TATYANA CHAVIER - PAGTO DE SALÁRIO,,0.0,1283.79,6002.66,INTER,Despesa com pessoal,Salário,../data/raw/BANCO INTER-2022.xlsx
2022-02-04,PIX ENVIADO MATHEUS CARDOSO VIEIRA - PAGTO DE SALÁRIO,,0.0,1283.79,4718.87,INTER,Despesa com pessoal,Salário,../data/raw/BANCO INTER-2022.xlsx
2022-02-04,PIX ENVIADO BEATRIZ CARDOSO VIEIRA - PAGTO DE SALÁRIO,,0.0,898.1,3820.77,INTER,Despesa com pessoal,Salário,../data/raw/BANCO INTER-2022.xlsx
2022-02-04,PIX ENVIADO LUIZ GUSTAVO DA SILVA - PAGTO DE SALÁRIO,,0.0,886.83,2933.94,INTER,Despesa com pessoal,Salário,../data/raw/BANCO INTER-2022.xlsx
2022-02-04,PIX RECEBIDO DAYSE LEANDRA DOS SANTOS,,150.0,0.0,3083.94,INTER,Receita com serviços,Outras,../data/raw/BANCO INTER-2022.xlsx
2022-02-04,PIX ENVIADO CARLOS - PAGTO DESPESAS,,0.0,925.6,2158.34,INTER,Despesa com serviços,Outras,../data/raw/BANCO INTER-2022.xlsx
2022-02-07,COMPRA CARTÃO BELA VISTA MORRETES,,0.0,65.0,2093.34,INTER,Despesa com produtos,Outras,../data/raw/BANCO INTER-2022.xlsx
2022-02-07,PIX RECEBIDO ORMEG COMERCIO DE PECAS E SERVICOS LTDA ,,143.0,0.0,2236.34,INTER,Receita com serviços,Outras,../data/raw/BANCO INTER-2022.xlsx
2022-02-07,PIX ENVIADO CLAUDIO PRO-LABORE,,0.0,1078.68,1157.66,INTER,Despesa com pessoal,Pró labore,../data/raw/BANCO INTER-2022.xlsx
2022-02-08,PIX ENVIADO MULTI FRIO REFRIGERAÇÕES - NF 022685,,0.0,51.94,1105.72,INTER,Despesa com serviços,Outras,../data/raw/BANCO INTER-2022.xlsx
2022-02-08,PIX RECEBIDO FERNANDO HENRIQUE COMIN TURRA,,125.0,0.0,1230.72,INTER,Receita com serviços,Outras,../data/raw/BANCO INTER-2022.xlsx
2022-02-09,PIX RECEBIDO VANESSA DE FREITAS MARIANTE,,150.0,0.0,1380.72,INTER,Receita com serviços,Outras,../data/raw/BANCO INTER-2022.xlsx
2022-02-09,PIX RECEBIDO PRISCILA FIGUEIREDO,,200.0,0.0,1580.72,INTER,Receita com serviços,Outras,../data/raw/BANCO INTER-2022.xlsx
2022-02-10,PIX RECEBIDO ANA LUCIA MAFFUD CILLI,,195.0,0.0,1775.72,INTER,Receita com serviços,Outras,../data/raw/BANCO INTER-2022.xlsx
2022-02-11,COMPRA CARTÃO CASA DE PARAFUSOS RAIO PINHAIS,,0.0,54.49,1721.23,INTER,Despesa com produtos,Outras,../data/raw/BANCO INTER-2022.xlsx
2022-02-11,PIX RECEBIDO POSSINELLI CONTABILIDADE E SERV EIREL,,1700.0,0.0,3421.23,INTER,Receita com serviços,Outras,../data/raw/BANCO INTER-2022.xlsx
2022-02-14,PIX RECEBIDO ALEX SANDRO RIEDEL VILLANOVA,,90.0,0.0,3511.23,INTER,Receita com serviços,Outras,../data/raw/BANCO INTER-2022.xlsx
2022-02-14,PAGAMENTO TÍTULO CANCELAMENTO DE SERVIÇO CARSYSTEN,,0.0,102.0,3409.23,INTER,Despesas administrativas,Veiculos,../data/raw/BANCO INTER-2022.xlsx
2022-02-14,COMPRA CARTÃO LANCHES O PRENSADAO CURITIBA,,0.0,31.0,3378.23,INTER,Despesa com produtos,Outras,../data/raw/BANCO INTER-2022.xlsx
2022-02-15,PIX RECEBIDO CRISTIANE CAETANO DE MORAIS,,220.0,0.0,3598.23,INTER,Receita com serviços,Outras,../data/raw/BANCO INTER-2022.xlsx
2022-02-15,PIX RECEBIDO NATIELLE DUARTE CORREA,,185.0,0.0,3783.23,INTER,Receita com serviços,Outras,../data/raw/BANCO INTER-2022.xlsx
2022-02-16,PIX RECEBIDO IVO DA SILVA JUNIOR,,220.0,0.0,4003.23,INTER,Receita com serviços,Outras,../data/raw/BANCO INTER-2022.xlsx
2022-02-17,PIX RECEBIDO EMERSON DIOGO RIBEIRO IZUMI,,750.0,0.0,4753.23,INTER,Receita com serviços,Outras,../data/raw/BANCO INTER-2022.xlsx
2022-02-17,PIX RECEBIDO MARCIA CRISTINA COSTA GROTE,,45.0,0.0,4798.23,INTER,Receita com serviços,Outras,../data/raw/BANCO INTER-2022.xlsx
2022-02-17,PIX RECEBIDO VANDERLEI BUSNARDO,,60.0,0.0,4858.23,INTER,Receita com serviços,Outras,../data/raw/BANCO INTER-2022.xlsx
2022-02-18,PIX RECEBIDO LEANDRO MAGATAO,,240.0,0.0,5098.23,INTER,Receita com serviços,Outras,../data/raw/BANCO INTER-2022.xlsx
2022-02-18,PIX RECEBIDO FABIO AUGUSTO NASCIMENTO FERREIRA,,60.0,0.0,5158.23,INTER,Receita com serviços,Outras,../data/raw/BANCO INTER-2022.xlsx
2022-02-18,PIX RECEBIDO LUIS FERNANDO C HARTMANN,,330.0,0.0,5488.23,INTER,Receita com serviços,Outras,../data/raw/BANCO INTER-2022.xlsx
2022-02-18,PIX RECEBIDO LUCAS DEL CASTANHEL DIAS,,285.0,0.0,5773.23,INTER,Receita com serviços,Outras,../data/raw/BANCO INTER-2022.xlsx
2022-02-18,PIX RECEBIDO MARCOS PAULO FERREIRA REIS,,95.0,0.0,5868.23,INTER,Receita com serviços,Outras,../data/raw/BANCO INTER-2022.xlsx
2022-02-18,CASHBACK CARTAO DE CREDITO,,5.49,0.0,5873.72,INTER,Receitas financeiras,Outras,../data/raw/BANCO INTER-2022.xlsx
2022-02-21,COMPRA CARTÃO POSTO OCEANO LTDA CURITIBA,,0.0,261.93,5611.79,INTER,Despesa com produtos,Outras,../data/raw/BANCO INTER-2022.xlsx
2022-02-21,PIX RECEBIDO MONIQUE MANSUR VALINHO,,40.0,0.0,5651.79,INTER,Receita com serviços,Outras,../data/raw/BANCO INTER-2022.xlsx
2022-02-21,PIX RECEBIDO JOSE DANTAS DE SOUSA,,100.0,0.0,5751.79,INTER,Receita com serviços,Outras,../data/raw/BANCO INTER-2022.xlsx
2022-02-21,PIX RECEBIDO LILIANE POSTAY,,100.0,0.0,5851.79,INTER,Receita com serviços,Outras,../data/raw/BANCO INTER-2022.xlsx
2022-02-21,PIX ENVIADO CARLOS EDUARDO TOCHETTO,,0.0,64.15,5787.64,INTER,Despesa com pessoal,Salário,../data/raw/BANCO INTER-2022.xlsx
2022-02-22,PIX RECEBIDO ADRIANA CRISTINA DA SILVA,,129.24,0.0,5916.88,INTER,Receita com serviços,Outras,../data/raw/BANCO INTER-2022.xlsx
2022-02-22,PIX RECEBIDO RAONI BRAGA DE PAULA EDUARDO,,60.0,0.0,5976.88,INTER,Receita com serviços,Outras,../data/raw/BANCO INTER-2022.xlsx
2022-02-23,PIX RECEBIDO ALEX VEEREN,,220.0,0.0,6196.88,INTER,Receita com serviços,Outras,../data/raw/BANCO INTER-2022.xlsx
2022-02-24,PIX RECEBIDO CLAUDEMIR FERREIRA,,110.0,0.0,6306.88,INTER,Receita com serviços,Outras,../data/raw/BANCO INTER-2022.xlsx
2022-02-24,PIX RECEBIDO LUIS ANTONIO OLIVATO,,80.0,0.0,6386.88,INTER,Receita com serviços,Outras,../data/raw/BANCO INTER-2022.xlsx
2022-02-25,PIX ENVIADO DANILO BARBOSA - TERCEIRO,,0.0,950.0,5436.88,INTER,Despesa com pessoal,Salário,../data/raw/BANCO INTER-2022.xlsx
2022-02-25,PIX RECEBIDO THEOPHANIO ROCHA DE OLIVEIRA JUNIOR,,330.0,0.0,5766.88,INTER,Receita com serviços,Outras,../data/raw/BANCO INTER-2022.xlsx
2022-02-25,PIX RECEBIDO IEDA MARIA GOMES GRE DA SILVA ME,,155.0,0.0,5921.88,INTER,Receita com serviços,Outras,../data/raw/BANCO INTER-2022.xlsx
2022-02-25,PIX RECEBIDO EMILE KAROLINE MANRICH,,330.0,0.0,6251.88,INTER,Receita com serviços,Outras,../data/raw/BANCO INTER-2022.xlsx
2022-02-25,PIX RECEBIDO RUI ALMEIDA MACOLA,,30.0,0.0,6281.88,INTER,Receita com serviços,Outras,../data/raw/BANCO INTER-2022.xlsx
2022-03-02,PIX RECEBIDO DIANA RIBEIRO COELHO MARQUES,,260.0,0.0,6541.88,INTER,Receita com serviços,Outras,../data/raw/BANCO INTER-2022.xlsx
2022-03-02,PIX RECEBIDO WILLIAN ROBERT FRIGHETTO,,235.0,0.0,6776.88,INTER,Receita com serviços,Outras,../data/raw/BANCO INTER-2022.xlsx
2022-03-02,PIX RECEBIDO MARCELO DE ALMEIDA CORREIA,,445.0,0.0,7221.88,INTER,Receita com serviços,Outras,../data/raw/BANCO INTER-2022.xlsx
2022-03-02,PIX RECEBIDO CLOVIS ROBERTO GURSKI,,190.0,0.0,7411.88,INTER,Receita com serviços,Outras,../data/raw/BANCO INTER-2022.xlsx
2022-03-02,PIX RECEBIDO RADHA MOVEIS E DECORACAO LTDA ME,,220.0,0.0,7631.88,INTER,Receita com serviços,Outras,../data/raw/BANCO INTER-2022.xlsx
2022-03-02,PIX RECEBIDO ROBSON PERON,,200.0,0.0,7831.88,INTER,Receita com serviços,Outras,../data/raw/BANCO INTER-2022.xlsx
2022-03-02,PIX RECEBIDO ROBSON PERON,,20.0,0.0,7851.88,INTER,Receita com serviços,Outras,../data/raw/BANCO INTER-2022.xlsx
2022-03-03,PIX ENVIADO GOVERNO DO PARANA SECRETARIA DE ESTAD,,0.0,299.5,7552.38,INTER,Despesas tributárias ,Outras,../data/raw/BANCO INTER-2022.xlsx
2022-03-03,PIX RECEBIDO LUCAS MICHELS PERICO,,220.0,0.0,7772.38,INTER,Receita com serviços,Outras,../data/raw/BANCO INTER-2022.xlsx
2022-03-03,PIX RECEBIDO PAULO MARCIO DIAS FERREIRA DE SOUZA,,220.0,0.0,7992.38,INTER,Receita com serviços,Outras,../data/raw/BANCO INTER-2022.xlsx
2022-03-03,PIX RECEBIDO JOAO ANTONIO N SANTOS,,210.0,0.0,8202.38,INTER,Receita com serviços,Outras,../data/raw/BANCO INTER-2022.xlsx
2022-03-03,PIX RECEBIDO ALEXANDRE DE LUNA PEDROSA,,100.0,0.0,8302.38,INTER,Receita com serviços,Outras,../data/raw/BANCO INTER-2022.xlsx
2022-03-04,PIX ENVIADO MATHEUS CARDOSO VIEIRA,,0.0,1373.21,6929.17,INTER,Despesa com pessoal,Salário,../data/raw/BANCO INTER-2022.xlsx
2022-03-04,PIX ENVIADO RAMON PEREIRA DE OLIVEIRA,,0.0,832.26,6096.91,INTER,Despesa com pessoal,Salário,../data/raw/BANCO INTER-2022.xlsx
2022-03-07,PIX RECEBIDO NATALIA FABIANO BUENO,,150.0,0.0,6246.91,INTER,Receita com serviços,Outras,../data/raw/BANCO INTER-2022.xlsx
2022-03-07,PIX ENVIADO CARLOS - PAGTO DESPESAS,,0.0,897.13,5349.78,INTER,Despesa com serviços,Outras,../data/raw/BANCO INTER-2022.xlsx
2022-03-07,PIX RECEBIDO BERNARDO GUARAGNA DA SILVA,,210.0,0.0,5559.78,INTER,Receita com serviços,Outras,../data/raw/BANCO INTER-2022.xlsx
2022-03-07,PIX RECEBIDO THIAGO CATTANI NAIDON,,220.0,0.0,5779.78,INTER,Receita com serviços,Outras,../data/raw/BANCO INTER-2022.xlsx
2022-03-07,COMPRA CARTÃO NICHELE MAT CONSTRUCAO,,0.0,24.84,5754.94,INTER,Despesa com produtos,Outras,../data/raw/BANCO INTER-2022.xlsx
2022-03-08,PIX RECEBIDO MARIA A BALLESTERO,,255.0,0.0,6009.94,INTER,Receita com serviços,Outras,../data/raw/BANCO INTER-2022.xlsx
2022-03-08,PIX RECEBIDO MADELI CAMISA CORREA,,180.0,0.0,6189.94,INTER,Receita com serviços,Outras,../data/raw/BANCO INTER-2022.xlsx
2022-03-08,PIX RECEBIDO RAISSA DE CAVASSIN MILANEZI,,200.0,0.0,6389.94,INTER,Receita com serviços,Outras,../data/raw/BANCO INTER-2022.xlsx
2022-03-08,PIX RECEBIDO RAFAEL MOORI PINTO,,390.0,0.0,6779.94,INTER,Receita com serviços,Outras,../data/raw/BANCO INTER-2022.xlsx
2022-03-08,PIX RECEBIDO SANDRA YUMI SHIRATO,,130.0,0.0,6909.94,INTER,Receita com serviços,Outras,../data/raw/BANCO INTER-2022.xlsx
2022-03-08,PIX RECEBIDO JACKELINE SANTANA FREITAS SATHLER,,220.0,0.0,7129.94,INTER,Receita com serviços,Outras,../data/raw/BANCO INTER-2022.xlsx
2022-03-09,PIX RECEBIDO JOSIAS ALVES,,110.0,0.0,7239.94,INTER,Receita com serviços,Outras,../data/raw/BANCO INTER-2022.xlsx
2022-03-10,PIX RECEBIDO LAERTE V DE G NETO,,330.0,0.0,7569.94,INTER,Receita com serviços,Outras,../data/raw/BANCO INTER-2022.xlsx
2022-03-11,PIX RECEBIDO RAISSA DE CAVASSIN MILANEZI,,160.0,0.0,7729.94,INTER,Receita com serviços,Outras,../data/raw/BANCO INTER-2022.xlsx
2022-03-11,PIX RECEBIDO MARLI APARECIDA DIAS,,375.0,0.0,8104.94,INTER,Receita com serviços,Outras,../data/raw/BANCO INTER-2022.xlsx
2022-03-11,PIX RECEBIDO ANGELO GABRIEL MARI,,330.0,0.0,8434.94,INTER,Receita com serviços,Outras,../data/raw/BANCO INTER-2022.xlsx
2022-03-14,COMPRA CARTÃO MARIACIRLEIDOSSAN PINHAIS B,,0.0,63.8,8371.14,INTER,Despesa com produtos,Outras,../data/raw/BANCO INTER-2022.xlsx
2022-03-14,PIX RECEBIDO ODILEI BADO,,220.0,0.0,8591.14,INTER,Receita com serviços,Outras,../data/raw/BANCO INTER-2022.xlsx
2022-03-14,PIX RECEBIDO BEATRIZ REGINA SANTOS,,410.0,0.0,9001.14,INTER,Receita com serviços,Outras,../data/raw/BANCO INTER-2022.xlsx
2022-03-14,PIX RECEBIDO CARLOS ALBERTO ROST FILHO,,350.0,0.0,9351.14,INTER,Receita com serviços,Outras,../data/raw/BANCO INTER-2022.xlsx
2022-03-14,PIX RECEBIDO ISRAEL ANTONIO SCUCATO,,75.0,0.0,9426.14,INTER,Receita com serviços,Outras,../data/raw/BANCO INTER-2022.xlsx
2022-03-14,PIX ENVIADO RAMON PEREIRA DE OLIVEIRA - PAGTO TERCEIRO,,0.0,955.81,8470.33,INTER,Despesa com pessoal,Salário,../data/raw/BANCO INTER-2022.xlsx
2022-03-15,PIX RECEBIDO CRISTIANO BRUN BINDER,,250.0,0.0,8720.33,INTER,Receita com serviços,Outras,../data/raw/BANCO INTER-2022.xlsx
2022-03-16,PIX RECEBIDO FERNANDA MONTECINO SASSE,,460.0,0.0,9180.33,INTER,Receita com serviços,Outras,../data/raw/BANCO INTER-2022.xlsx
2022-03-16,PIX RECEBIDO GEISON VICENTE,,150.0,0.0,9330.33,INTER,Receita com serviços,Outras,../data/raw/BANCO INTER-2022.xlsx
2022-03-17,PIX RECEBIDO CARMEM HEPP,,335.0,0.0,9665.33,INTER,Receita com serviços,Outras,../data/raw/BANCO INTER-2022.xlsx
2022-03-17,PIX RECEBIDO LETICIA CORREA DE SOUSA,,30.0,0.0,9695.33,INTER,Receita com serviços,Outras,../data/raw/BANCO INTER-2022.xlsx
2022-03-17,PIX RECEBIDO MARIA MARLI S. WANDEUR,,65.0,0.0,9760.33,INTER,Receita com serviços,Outras,../data/raw/BANCO INTER-2022.xlsx
2022-03-17,PIX ENVIADO KABUM COM. ELETRÔNICO ,,0.0,399.8,9360.53,INTER,Despesas administrativas,Material de escritório,../data/raw/BANCO INTER-2022.xlsx
2022-03-17,PIX ENVIADO KABUM COM. ELETRÔNICO ,,0.0,399.8,8960.73,INTER,Despesas administrativas,Material de escritório,../data/raw/BANCO INTER-2022.xlsx
2022-03-18,PIX RECEBIDO NATALIA PEDRINI SCANFERLA,,60.0,0.0,9020.73,INTER,Receita com serviços,Outras,../data/raw/BANCO INTER-2022.xlsx
2022-03-18,PIX ENVIADO GEYSON - DEVOLUÇÃO PAGTO RECEBIDO PELO PIC PAY ,,0.0,97.0,8923.73,INTER,Transferência (Débito),Transferência / Reembolso,../data/raw/BANCO INTER-2022.xlsx
2022-03-18,PIX RECEBIDO GABRIELLE SENO ALFIERI,,60.0,0.0,8983.73,INTER,Receita com serviços,Outras,../data/raw/BANCO INTER-2022.xlsx
2022-03-18,PIX RECEBIDO LUCIA HELENA DE FREITAS,,115.0,0.0,9098.73,INTER,Receita com serviços,Outras,../data/raw/BANCO INTER-2022.xlsx
2022-03-18,PIX RECEBIDO MARLON DAVID KIPPER,,275.0,0.0,9373.73,INTER,Receita com serviços,Outras,../data/raw/BANCO INTER-2022.xlsx
2022-03-18,PIX RECEBIDO DAYSE LEANDRA DOS SANTOS,,205.0,0.0,9578.73,INTER,Receita com serviços,Outras,../data/raw/BANCO INTER-2022.xlsx
2022-03-18,PAGAMENTO CARTÃO INTER,,0.0,1632.12,7946.61,INTER,Despesas administrativas,Outras,../data/raw/BANCO INTER-2022.xlsx
2022-03-18,DOC CREDITO ROBERTO M RESENDE,,365.0,0.0,8311.61,INTER,Receita com serviços,Outras,../data/raw/BANCO INTER-2022.xlsx
2022-03-21,PIX RECEBIDO ADRIANO ASTRIGI DOMINGOS,,665.0,0.0,8976.61,INTER,Receita com serviços,Outras,../data/raw/BANCO INTER-2022.xlsx
2022-03-21,PIX RECEBIDO PRISCILA BRUN VENANCIO,,190.0,0.0,9166.61,INTER,Receita com serviços,Outras,../data/raw/BANCO INTER-2022.xlsx
2022-03-21,COMPRA CARTÃO PAG*ZXCOMERCIO MATERIAL DE CONSUMO,,0.0,135.3,9031.31,INTER,Despesa com produtos,Materiais de Consumo,../data/raw/BANCO INTER-2022.xlsx
2022-03-21,PIX RECEBIDO MAYARA APARECIDA TELLES SILVA,,220.0,0.0,9251.31,INTER,Receita com serviços,Outras,../data/raw/BANCO INTER-2022.xlsx
2022-03-22,PIX ENVIADO MARKETPLACE-SOPRADOR CABO DE AR QUENTE,,0.0,85.0,9166.31,INTER,Despesa com serviços,Outras,../data/raw/BANCO INTER-2022.xlsx
2022-03-22,PIX RECEBIDO ISRAEL ANTONIO SCUCATO,,75.0,0.0,9241.31,INTER,Receita com serviços,Outras,../data/raw/BANCO INTER-2022.xlsx
2022-03-23,PIX RECEBIDO ANGELA MARIA HADDAD FAFA,,465.0,0.0,9706.31,INTER,Receita com serviços,Outras,../data/raw/BANCO INTER-2022.xlsx
2022-03-23,CASHBACK CARTAO DE CREDITO,,4.08,0.0,9710.39,INTER,Receitas financeiras,Outras,../data/raw/BANCO INTER-2022.xlsx
2022-03-24,PIX RECEBIDO -WAGNER FRADE,,330.0,0.0,10040.39,INTER,Receita com serviços,Outras,../data/raw/BANCO INTER-2022.xlsx
2022-03-24,PIX RECEBIDO MANOEL AUGUSTO REZENDE,,330.0,0.0,10370.39,INTER,Receita com serviços,Outras,../data/raw/BANCO INTER-2022.xlsx
2022-03-24,PIX RECEBIDO PEDRO JUNIOR PASSAFARO PEREIRA,,77.5,0.0,10447.89,INTER,Receita com serviços,Outras,../data/raw/BANCO INTER-2022.xlsx
2022-03-25,PIX RECEBIDO MAIARA SANTANNA PINHEIRO,,180.0,0.0,10627.89,INTER,Receita com serviços,Outras,../data/raw/BANCO INTER-2022.xlsx
2022-03-25,PIX RECEBIDO DORIS RAQUEL B TEJADA,,580.0,0.0,11207.89,INTER,Receita com serviços,Outras,../data/raw/BANCO INTER-2022.xlsx
2022-03-25,PIX RECEBIDO ANA MARIA JUNKES COLOMBO,,335.0,0.0,11542.89,INTER,Receita com serviços,Outras,../data/raw/BANCO INTER-2022.xlsx
2022-03-28,PIX RECEBIDO JULIANO MENEGUZZI DE BERNERT,,375.0,0.0,11917.89,INTER,Receita com serviços,Outras,../data/raw/BANCO INTER-2022.xlsx
2022-03-28,PIX RECEBIDO WANDA CRISTINA BELINI DE MELLO,,210.0,0.0,12127.89,INTER,Receita com serviços,Outras,../data/raw/BANCO INTER-2022.xlsx
2022-03-28,PIX RECEBIDO DANIEL LEAL NAGASAVA,,130.0,0.0,12257.89,INTER,Receita com serviços,Outras,../data/raw/BANCO INTER-2022.xlsx
2022-03-28,PIX RECEBIDO MARCIA MARIA ROCHA DE MELLO,,260.0,0.0,12517.89,INTER,Receita com serviços,Outras,../data/raw/BANCO INTER-2022.xlsx
2022-03-28,TED RECEBIDO ELIANE DE OLIVEIRA,,170.0,0.0,12687.89,INTER,Receita com serviços,Outras,../data/raw/BANCO INTER-2022.xlsx
2022-03-28,PIX RECEBIDO MAXIMILIANO HAHN DALLA PORTA,,330.0,0.0,13017.89,INTER,Receita com serviços,Outras,../data/raw/BANCO INTER-2022.xlsx
2022-03-28,PIX RECEBIDO FLAVIO SCHUTZER DE GODOY,,330.0,0.0,13347.89,INTER,Receita com serviços,Outras,../data/raw/BANCO INTER-2022.xlsx
2022-03-28,PIX RECEBIDO ROBERTO BRUNO PEREIRA SILVA,,330.0,0.0,13677.89,INTER,Receita com serviços,Outras,../data/raw/BANCO INTER-2022.xlsx
2022-03-29,PIX RECEBIDO SILVANA ROSSI,,60.0,0.0,13737.89,INTER,Receita com serviços,Outras,../data/raw/BANCO INTER-2022.xlsx
2022-03-29,COMPRA CARTÃO MERCADO ZAMPROGNA,,0.0,73.42,13664.47,INTER,Despesa com produtos,Outras,../data/raw/BANCO INTER-2022.xlsx
2022-03-30,PIX RECEBIDO DAYANE FERNANDA DOS REIS SILVEIRA,,220.0,0.0,13884.47,INTER,Receita com serviços,Outras,../data/raw/BANCO INTER-2022.xlsx
2022-03-30,PIX ENVIADO SILVANA ROSS I- DEVOLUÇÃO DE PIX 29/03/22,,0.0,60.0,13824.47,INTER,Transferência (Débito),Transferência / Reembolso,../data/raw/BANCO INTER-2022.xlsx
2022-03-30,PIX RECEBIDO JONATAS BATISTA,,100.0,0.0,13924.47,INTER,Receita com serviços,Outras,../data/raw/BANCO INTER-2022.xlsx
2022-03-30,PIX RECEBIDO ADILSON CASIRAGHI,,1000.0,0.0,14924.47,INTER,Receita com serviços,Outras,../data/raw/BANCO INTER-2022.xlsx
2022-03-31,PIX RECEBIDO CONSUELO SERENATO,,130.0,0.0,15054.47,INTER,Receita com serviços,Outras,../data/raw/BANCO INTER-2022.xlsx
2022-03-31,PIX RECEBIDO ALEXANDRE HENRIQUE S ROMEIRO,,330.0,0.0,15384.47,INTER,Receita com serviços,Outras,../data/raw/BANCO INTER-2022.xlsx
2022-03-31,PIX RECEBIDO RAISSA DE ARAUJO OLIVEIRA 03959536186,,220.0,0.0,15604.47,INTER,Receita com serviços,Outras,../data/raw/BANCO INTER-2022.xlsx
2022-03-31,PIX RECEBIDO RENATA R SAGAS DA SILVA,,150.0,0.0,15754.47,INTER,Receita com serviços,Outras,../data/raw/BANCO INTER-2022.xlsx
2022-04-01,PIX RECEBIDO NILTON BASCHIROTTO FILHO,,220.0,0.0,15974.47,INTER,Receita com serviços,Outras,../data/raw/BANCO INTER-2022.xlsx
2022-04-01,PIX RECEBIDO TELMA ZANIA R A M SALLES,,545.0,0.0,16519.47,INTER,Receita com serviços,Outras,../data/raw/BANCO INTER-2022.xlsx
2022-04-01,PIX RECEBIDO JUSSARA DE PAULA ADARIO LOBO,,445.0,0.0,16964.47,INTER,Receita com serviços,Outras,../data/raw/BANCO INTER-2022.xlsx
2022-04-01,PIX RECEBIDO LUCIANE LINHARES LUZZI,,350.0,0.0,17314.47,INTER,Receita com serviços,Outras,../data/raw/BANCO INTER-2022.xlsx
2022-04-01,PIX RECEBIDO ALMERINDA AGRELLI,,260.0,0.0,17574.47,INTER,Receita com serviços,Outras,../data/raw/BANCO INTER-2022.xlsx
2022-04-04,PIX RECEBIDO ADRIANA PINOTTI,,130.0,0.0,17704.47,INTER,Receita com serviços,Outras,../data/raw/BANCO INTER-2022.xlsx
2022-04-04,PIX RECEBIDO MATHEUS FELIPE CARVALHO,,150.0,0.0,17854.47,INTER,Receita com serviços,Outras,../data/raw/BANCO INTER-2022.xlsx
2022-04-04,PIX RECEBIDO JOEL DE FRANCA PADESKI ,,305.0,0.0,18159.47,INTER,Receita com serviços,Outras,../data/raw/BANCO INTER-2022.xlsx
2022-04-04,PIX RECEBIDO WASHINGTON BENIGNO DE FREITAS,,330.0,0.0,18489.47,INTER,Receita com serviços,Outras,../data/raw/BANCO INTER-2022.xlsx
2022-04-04,PIX RECEBIDO KARINE STEBULAITIS,,30.0,0.0,18519.47,INTER,Receita com serviços,Outras,../data/raw/BANCO INTER-2022.xlsx
2022-04-05,COMPRA CARTÃO STAMPAFER - RDW COM DE FERRO E AÇO NF 20749,,0.0,86.7,18432.77,INTER,Despesa com produtos,Outras,../data/raw/BANCO INTER-2022.xlsx
2022-04-06,PIX ENVIADO RAMON P. DE OLIVEIRA - RASTREADOR DA MOTO,,0.0,150.0,18282.77,INTER,Despesas administrativas,Peças/acessórios veiculos,../data/raw/BANCO INTER-2022.xlsx
2022-04-06,PIX RECEBIDO LIDIA GARANI SCHNEIDER,,200.0,0.0,18482.77,INTER,Receita com serviços,Outras,../data/raw/BANCO INTER-2022.xlsx
2022-04-06,PIX ENVIADO TATYANA CHAVIER - PAGTO SALÁRIO,,0.0,1722.1,16760.67,INTER,Despesa com pessoal,Salário,../data/raw/BANCO INTER-2022.xlsx
2022-04-06,PIX ENVIADO FERNANDA MARQUES CARBONE - PAGTO SALÁRIO,,0.0,1535.41,15225.26,INTER,Despesa com pessoal,Salário,../data/raw/BANCO INTER-2022.xlsx
2022-04-06,PIX ENVIADO GOVERNO DO PARANA SECRETARIA DE ESTAD - IPVA  2022 MOTO,,0.0,493.99,14731.27,INTER,Despesas tributárias ,IPVA,../data/raw/BANCO INTER-2022.xlsx
2022-04-07,PIX RECEBIDO FERNANDO AUGUSTO MONTA,,25.0,0.0,14756.27,INTER,Receita com serviços,Outras,../data/raw/BANCO INTER-2022.xlsx
2022-04-07,PIX RECEBIDO VITOR DE DRUSINA BUSS,,630.0,0.0,15386.27,INTER,Receita com serviços,Outras,../data/raw/BANCO INTER-2022.xlsx
2022-04-08,COMPRA CARTÃO POSTO CANAL CAPITAL VERDE-COMBUSTÍVEL,,0.0,70.42,15315.85,INTER,Despesas administrativas,Combustivel,../data/raw/BANCO INTER-2022.xlsx
2022-04-11,PIX RECEBIDO JULIANA DA SILVA BERNSTORFF,,30.0,0.0,15345.85,INTER,Receita com serviços,Outras,../data/raw/BANCO INTER-2022.xlsx
2022-04-11,PIX RECEBIDO CARLOS ALBERTO DUTRA,,205.0,0.0,15550.85,INTER,Receita com serviços,Outras,../data/raw/BANCO INTER-2022.xlsx
2022-04-11,PIX RECEBIDO ANDRESSA SABRINA PIAZZA,,330.0,0.0,15880.85,INTER,Receita com serviços,Outras,../data/raw/BANCO INTER-2022.xlsx
2022-04-11,PIX RECEBIDO KASSANDRA LACERDA DO NASCIMENTO,,50.0,0.0,15930.85,INTER,Receita com serviços,Outras,../data/raw/BANCO INTER-2022.xlsx
2022-04-12,PIX RECEBIDO RONALD PEREIRA GONCALVES,,490.0,0.0,16420.85,INTER,Receita com serviços,Outras,../data/raw/BANCO INTER-2022.xlsx
2022-04-12,PIX RECEBIDO CARMEM HEPP,,335.0,0.0,16755.85,INTER,Receita com serviços,Outras,../data/raw/BANCO INTER-2022.xlsx
2022-04-12,PIX ENVIADO JANSEN WELLNER,,0.0,100.0,16655.85,INTER,Despesa com serviços,Outras,../data/raw/BANCO INTER-2022.xlsx
2022-04-12,PIX ENVIADO MATERIAIS DE CONSTRUCAO MAFREI,,0.0,695.0,15960.85,INTER,Despesas administrativas,Manutenção predial,../data/raw/BANCO INTER-2022.xlsx
2022-04-12,PAGAMENTO FATURA CARTÃO INTER,,0.0,1639.77,14321.08,INTER,Despesas administrativas,Outras,../data/raw/BANCO INTER-2022.xlsx
2022-04-13,PIX RECEBIDO CARLA CRISTINA MOREIRA INACIO RODRIGU,,220.0,0.0,14541.08,INTER,Receita com serviços,Outras,../data/raw/BANCO INTER-2022.xlsx
2022-04-13,PAGAMENTO COPEL - CONTA DE ENERGIA LJ 3,,0.0,237.38,14303.7,INTER,Despesas administrativas,Energia,../data/raw/BANCO INTER-2022.xlsx
2022-04-13,PAGAMENTO COPEL - CONTA DE ENERGIA LJ 4,,0.0,91.45,14212.25,INTER,Despesas administrativas,Energia,../data/raw/BANCO INTER-2022.xlsx
2022-04-13,PAGAMENTO COPEL - CONTA DE ENERGIA LJ 6,,0.0,541.24,13671.01,INTER,Despesas administrativas,Energia,../data/raw/BANCO INTER-2022.xlsx
2022-04-13,PIX RECEBIDO CLAUDIA OLIVEIRA M CARVALHO,,220.0,0.0,13891.01,INTER,Receita com serviços,Outras,../data/raw/BANCO INTER-2022.xlsx
2022-04-13,PIX ENVIADO EDRIC P/ PAGTO TRANSF. MOTO E ACESSÓRIOS,,0.0,469.5,13421.51,INTER,Despesas administrativas,Peças/acessórios veiculos,../data/raw/BANCO INTER-2022.xlsx
2022-04-13,PIX RECEBIDO DIEGO AMARAL,,150.0,0.0,13571.51,INTER,Receita com serviços,Outras,../data/raw/BANCO INTER-2022.xlsx
2022-04-13,PIX RECEBIDO FERNANDO AUGUSTO N OLIVEIRA,,222.0,0.0,13793.51,INTER,Receita com serviços,Outras,../data/raw/BANCO INTER-2022.xlsx
2022-04-13,PIX RECEBIDO ROBERTO DE SOUSA,,330.0,0.0,14123.51,INTER,Receita com serviços,Outras,../data/raw/BANCO INTER-2022.xlsx
2022-04-13,PIX RECEBIDO ANTONIO NASCIMENTO,,55.0,0.0,14178.51,INTER,Receita com serviços,Outras,../data/raw/BANCO INTER-2022.xlsx
2022-04-13,CASHBACK CARTAO DE CREDITO,,4.09,0.0,14182.6,INTER,Receitas financeiras,Outras,../data/raw/BANCO INTER-2022.xlsx
2022-04-14,PIX RECEBIDO MARCOS FLAVIO S CASTRO,,452.5,0.0,14635.1,INTER,Receita com serviços,Outras,../data/raw/BANCO INTER-2022.xlsx
2022-04-14,PIX RECEBIDO JUSSARA FERNANDES DA SILVA,,35.0,0.0,14670.1,INTER,Receita com serviços,Outras,../data/raw/BANCO INTER-2022.xlsx
2022-04-18,PIX ENVIADO MARKETPLACE,,0.0,76.43,14593.67,INTER,Despesa com serviços,Outras,../data/raw/BANCO INTER-2022.xlsx
2022-04-18,PIX RECEBIDO ANTONIO NASCIMENTO,,5.0,0.0,14598.67,INTER,Receita com serviços,Outras,../data/raw/BANCO INTER-2022.xlsx
2022-04-19,PIX DEVOLUCAO RECEBIDA MARKETPLACE,,76.43,0.0,14675.1,INTER,Receita com serviços,Outras,../data/raw/BANCO INTER-2022.xlsx
2022-04-19,PAGAMENTO DARF - IRRF REF ALUGUEL IMÓVEL,,0.0,84.58,14590.52,INTER,Despesas tributárias ,Outras,../data/raw/BANCO INTER-2022.xlsx
2022-04-19,PAGAMENTO COPEL FIBRA,,0.0,149.9,14440.62,INTER,Despesa com produtos,Materiais de Consumo,../data/raw/BANCO INTER-2022.xlsx
2022-04-19,PAGAMENTO NET FONE,,0.0,124.92,14315.7,INTER,Despesas administrativas,"Telefonia (Celular, Fixo, Internet)",../data/raw/BANCO INTER-2022.xlsx
2022-04-19,PIX ENVIADO RAMON PAGTO DE ADIANTAMENTO QUINZENAL,,0.0,800.0,13515.7,INTER,Despesa com pessoal,Salário,../data/raw/BANCO INTER-2022.xlsx
2022-04-20,PIX RECEBIDO ANDERSON DAIVIS DOS SANTOS MELO,,330.0,0.0,13845.7,INTER,Receita com serviços,Outras,../data/raw/BANCO INTER-2022.xlsx
2022-04-20,PIX RECEBIDO SILVIA CREPALDI,,80.0,0.0,13925.7,INTER,Receita com serviços,Outras,../data/raw/BANCO INTER-2022.xlsx
2022-04-20,PIX RECEBIDO THIESA DE MULLER CESCO,,70.0,0.0,13995.7,INTER,Receita com serviços,Outras,../data/raw/BANCO INTER-2022.xlsx
2022-04-20,PIX RECEBIDO BRUNA DOS SANTOS ULYSSEA,,220.0,0.0,14215.7,INTER,Receita com serviços,Outras,../data/raw/BANCO INTER-2022.xlsx
2022-04-20,PIX ENVIADO ILIDIO MIGUEL MARTINS DE ALMEIDA - PEDREIRO,,0.0,1400.0,12815.7,INTER,Despesa com serviços,Mão de obra,../data/raw/BANCO INTER-2022.xlsx
2022-04-22,PIX RECEBIDO REGINALDO TENORIO DE LIMA,,80.0,0.0,12895.7,INTER,Receita com serviços,Outras,../data/raw/BANCO INTER-2022.xlsx
2022-04-22,PIX RECEBIDO CAROLINE PEREIRA BONA,,460.0,0.0,13355.7,INTER,Receita com serviços,Outras,../data/raw/BANCO INTER-2022.xlsx
2022-04-25,COMPRA CARTÃO NOVA ESTANCIA RESTAURANTE-MARMITA HORA EXTRAS ,,0.0,107.99,13247.71,INTER,Despesa com pessoal,Alimentação (VR VA),../data/raw/BANCO INTER-2022.xlsx
2022-04-25,PIX RECEBIDO ALINE APARECIDA FERRAUDO,,60.0,0.0,13307.71,INTER,Receita com serviços,Outras,../data/raw/BANCO INTER-2022.xlsx
2022-04-25,PIX RECEBIDO FRANCINE BARROS OLIVEIRA,,30.0,0.0,13337.71,INTER,Receita com serviços,Outras,../data/raw/BANCO INTER-2022.xlsx
2022-04-25,PIX RECEBIDO NORALMI FERREIRA DE ABREU,,330.0,0.0,13667.71,INTER,Receita com serviços,Outras,../data/raw/BANCO INTER-2022.xlsx
2022-04-26,COMPRA CARTÃO AUTO POSTO CONSUL,,0.0,40.5,13627.21,INTER,Despesa com produtos,Outras,../data/raw/BANCO INTER-2022.xlsx
2022-04-26,PIX RECEBIDO INGRID ALVES ROSA MARIANO,,250.0,0.0,13877.21,INTER,Receita com serviços,Outras,../data/raw/BANCO INTER-2022.xlsx
2022-04-29,PIX RECEBIDO DIEGO MOLINA GIANEZI,,250.0,0.0,14127.21,INTER,Receita com serviços,Outras,../data/raw/BANCO INTER-2022.xlsx
2022-05-02,COMPRA CARTÃO DTP MOTOSHOP CURITIBA,,0.0,47.43,14079.78,INTER,Despesa com produtos,Outras,../data/raw/BANCO INTER-2022.xlsx
2022-05-02,COMPRA CARTÃO SUPER PRO BETTEGA,,0.0,74.15,14005.63,INTER,Despesa com produtos,Outras,../data/raw/BANCO INTER-2022.xlsx
2022-05-02,PIX ENVIADO GOVERNO DO PARANA SECRETARIA DE ESTADO-GRPR,,0.0,408.78,13596.85,INTER,Despesas tributárias ,Outras,../data/raw/BANCO INTER-2022.xlsx
2022-05-02,PIX RECEBIDO LARISSA ALCANTARA PEREIRA,,60.0,0.0,13656.85,INTER,Receita com serviços,Outras,../data/raw/BANCO INTER-2022.xlsx
2022-05-03,COMPRA CARTÃO ALVORADA MATRIZ CURITIBA,,0.0,32.6,13624.25,INTER,Despesa com produtos,Outras,../data/raw/BANCO INTER-2022.xlsx
2022-05-03,PIX RECEBIDO PEDRO CEZAR VINHOLI,,345.0,0.0,13969.25,INTER,Receita com serviços,Outras,../data/raw/BANCO INTER-2022.xlsx
2022-05-03,PIX ENVIADO MATHEUS H. D. ROCHA - VT ESTAGIÁRIO,,0.0,242.0,13727.25,INTER,Despesa com pessoal,Transporte (VT),../data/raw/BANCO INTER-2022.xlsx
2022-05-03,PIX RECEBIDO NÍCOLAS IRINEU TEIXEIRA,,635.0,0.0,14362.25,INTER,Receita com serviços,Outras,../data/raw/BANCO INTER-2022.xlsx
2022-05-04,PIX RECEBIDO SUELEN WOLF,,345.0,0.0,14707.25,INTER,Receita com serviços,Outras,../data/raw/BANCO INTER-2022.xlsx
2022-05-04,PIX RECEBIDO SILVANO CARMECINI,,350.0,0.0,15057.25,INTER,Receita com serviços,Outras,../data/raw/BANCO INTER-2022.xlsx
2022-05-05,COMPRA CARTÃO TECNOMOLD SIGNS - MAT. COBERTURA ESCADA,,0.0,273.9,14783.35,INTER,Despesas administrativas,Manutenção predial,../data/raw/BANCO INTER-2022.xlsx
2022-05-05,PIX RECEBIDO LUIZ CARLOS DE MAGALHAES SOARES,,220.0,0.0,15003.35,INTER,Receita com serviços,Outras,../data/raw/BANCO INTER-2022.xlsx
2022-05-05,PIX RECEBIDO GUSTAVO HENRIQUE BATISTA QUINTAO,,500.0,0.0,15503.35,INTER,Receita com serviços,Outras,../data/raw/BANCO INTER-2022.xlsx
2022-05-06,PIX RECEBIDO CWB SERVICOS DE INSTALACOES ELETR,,640.0,0.0,16143.35,INTER,Receita com serviços,Outras,../data/raw/BANCO INTER-2022.xlsx
2022-05-06,PIX ENVIADO TATYANA CHAVIER,,0.0,1810.48,14332.87,INTER,Despesa com pessoal,Salário,../data/raw/BANCO INTER-2022.xlsx
2022-05-06,PIX ENVIADO MATHEUS CARDOSO VIEIRA,,0.0,1519.56,12813.31,INTER,Despesa com pessoal,Salário,../data/raw/BANCO INTER-2022.xlsx
2022-05-06,PIX ENVIADO FERNANDA MARQUES CARBONE,,0.0,1539.26,11274.05,INTER,Despesa com pessoal,Salário,../data/raw/BANCO INTER-2022.xlsx
2022-05-06,PIX ENVIADO LUIZ GUSTAVO DA SILVA,,0.0,1435.11,9838.94,INTER,Despesa com pessoal,Salário,../data/raw/BANCO INTER-2022.xlsx
2022-05-09,PIX RECEBIDO SANDRO GALPERIN,,980.0,0.0,10818.94,INTER,Receita com serviços,Outras,../data/raw/BANCO INTER-2022.xlsx
2022-05-10,PIX RECEBIDO ANA CAROLINA MARTINS AZEVEDO,,265.0,0.0,11083.94,INTER,Receita com serviços,Outras,../data/raw/BANCO INTER-2022.xlsx
2022-05-11,PIX ENVIADO SILVANO CARMECINI - DEVOLUÇÃO PARCIAL DE PIX 04/05/22,,0.0,150.0,10933.94,INTER,Transferência (Débito),Transferência / Reembolso,../data/raw/BANCO INTER-2022.xlsx
2022-05-11,PIX RECEBIDO ADRIANA DA SILVA LOURENCO,,450.0,0.0,11383.94,INTER,Receita com serviços,Outras,../data/raw/BANCO INTER-2022.xlsx
2022-05-12,PIX RECEBIDO FELIPE AUGUSTO MIRANDA FACANHA,,330.0,0.0,11713.94,INTER,Receita com serviços,Outras,../data/raw/BANCO INTER-2022.xlsx
2022-05-12,COMPRA CARTÃO DROGARIA CATARINENSE - AUTOTESTE COVID-19,,0.0,119.8,11594.14,INTER,Despesa com pessoal,Outras,../data/raw/BANCO INTER-2022.xlsx
2022-05-12,PIX RECEBIDO ANDREA ACIOLI DE BARROS,,220.0,0.0,11814.14,INTER,Receita com serviços,Outras,../data/raw/BANCO INTER-2022.xlsx
2022-05-12,PIX RECEBIDO DENIS EDUARDO CARVALHO,,40.0,0.0,11854.14,INTER,Receita com serviços,Outras,../data/raw/BANCO INTER-2022.xlsx
2022-05-13,PIX RECEBIDO MANAX ENGENHARIA LTDA - ME,,390.0,0.0,12244.14,INTER,Receita com serviços,Outras,../data/raw/BANCO INTER-2022.xlsx
2022-05-13,PIX RECEBIDO DENISE MONTIEL NUNES,,330.0,0.0,12574.14,INTER,Receita com serviços,Outras,../data/raw/BANCO INTER-2022.xlsx
2022-05-13,PIX ENVIADO DANILO BARBOSA - PAGTO TERCEIRO,,0.0,500.0,12074.14,INTER,Despesa com pessoal,Salário,../data/raw/BANCO INTER-2022.xlsx
2022-05-16,PIX RECEBIDO MATHEUS CANDIDO DA SILVA,,135.0,0.0,12209.14,INTER,Receita com serviços,Outras,../data/raw/BANCO INTER-2022.xlsx
2022-05-16,COMPRA CARTÃO PAG*CHECKBOX CURITIBA,,0.0,240.0,11969.14,INTER,Despesa com produtos,Outras,../data/raw/BANCO INTER-2022.xlsx
2022-05-17,PIX ENVIADO MEGA AR STORE NF 1990 - MATERIAL DE CONSUMO,,0.0,312.66,11656.48,INTER,Despesa com produtos,Materiais de Consumo,../data/raw/BANCO INTER-2022.xlsx
2022-05-17,PIX RECEBIDO MARCOS FLAVIO S CASTRO,,452.5,0.0,12108.98,INTER,Receita com serviços,Outras,../data/raw/BANCO INTER-2022.xlsx
2022-05-17,COMPRA CARTÃO CONTABILISTA PAPELARIA NF 132.868,,0.0,343.12,11765.86,INTER,Despesas administrativas,Material de escritório,../data/raw/BANCO INTER-2022.xlsx
2022-05-19,PIX ENVIADO ROBSON - COMPRA MAT. CONSTRUÇÃO,,0.0,28.9,11736.96,INTER,Despesas administrativas,Manutenção predial,../data/raw/BANCO INTER-2022.xlsx
2022-05-19,PIX RECEBIDO JOÃO GUILHERME JUNG,,80.0,0.0,11816.96,INTER,Receita com serviços,Outras,../data/raw/BANCO INTER-2022.xlsx
2022-05-19,PIX RECEBIDO BRUNA OLIVEIRA RAMOS,,120.0,0.0,11936.96,INTER,Receita com serviços,Outras,../data/raw/BANCO INTER-2022.xlsx
2022-05-19,PIX RECEBIDO JULIA THIEMI MORIGAKI,,125.0,0.0,12061.96,INTER,Receita com serviços,Outras,../data/raw/BANCO INTER-2022.xlsx
2022-05-19,PIX ENVIADO BEATRIZ - PAGTO TERCEIRO,,0.0,551.18,11510.78,INTER,Despesa com pessoal,Salário,../data/raw/BANCO INTER-2022.xlsx
2022-05-19,PIX RECEBIDO ALDO ESMERIO DE OLIVEIRA JUNIOR,,220.0,0.0,11730.78,INTER,Receita com serviços,Outras,../data/raw/BANCO INTER-2022.xlsx
2022-05-20,PIX RECEBIDO NATALIA VENDRAMINI DOS REIS,,220.0,0.0,11950.78,INTER,Receita com serviços,Outras,../data/raw/BANCO INTER-2022.xlsx
2022-05-20,PIX RECEBIDO IGOR MARINS RODRIGUES,,490.0,0.0,12440.78,INTER,Receita com serviços,Outras,../data/raw/BANCO INTER-2022.xlsx
2022-05-20,PIX RECEBIDO ALEXSANDRA DOMBEKET MACANHAN,,250.0,0.0,12690.78,INTER,Receita com serviços,Outras,../data/raw/BANCO INTER-2022.xlsx
2022-05-23,COMPRA CARTÃO OXIMILLE CURITIBA ,,0.0,222.5,12468.28,INTER,Despesa com produtos,Outras,../data/raw/BANCO INTER-2022.xlsx
2022-05-23,CASHBACK CARTAO DE CREDITO,,6.48,0.0,12474.76,INTER,Receitas financeiras,Outras,../data/raw/BANCO INTER-2022.xlsx
2022-05-24,COMPRA CARTÃO FELIPE B. D. GONÇALVES NFS-e 386 -RECARGA EXTINTORES,,0.0,120.0,12354.76,INTER,Despesa com serviços,Outras,../data/raw/BANCO INTER-2022.xlsx
2022-05-25,PIX RECEBIDO GUTEMBERG ADVINCULA AGUIAR,,280.0,0.0,12634.76,INTER,Receita com serviços,Outras,../data/raw/BANCO INTER-2022.xlsx
2022-05-26,PIX RECEBIDO MARCOS PAULO FERREIRA REIS,,95.0,0.0,12729.76,INTER,Receita com serviços,Outras,../data/raw/BANCO INTER-2022.xlsx
2022-05-27,PIX RECEBIDO ELISERLEI M ROCKENBACH,,280.0,0.0,13009.76,INTER,Receita com serviços,Outras,../data/raw/BANCO INTER-2022.xlsx
2022-05-27,PIX RECEBIDO FABIO MARCELLO FARIA LIPPMANN,,330.0,0.0,13339.76,INTER,Receita com serviços,Outras,../data/raw/BANCO INTER-2022.xlsx
2022-05-30,PIX RECEBIDO NADIA NAIR LOPES BRASCHER,,280.0,0.0,13619.76,INTER,Receita com serviços,Outras,../data/raw/BANCO INTER-2022.xlsx
2022-06-01,PIX ENVIADO ALDO ESMERIO DE OLIVEIRA JUNIOR - DEVOLUÇÃO DE PIX 19/05/22,,0.0,220.0,13399.76,INTER,Transferência (Débito),Transferência / Reembolso,../data/raw/BANCO INTER-2022.xlsx
2022-06-01,PIX ENVIADO GOVERNO DO PARANA SECRETARIA DE ESTADO-GRPR,,0.0,276.26,13123.5,INTER,Despesas tributárias ,Outras,../data/raw/BANCO INTER-2022.xlsx
2022-06-02,PIX RECEBIDO LEONARDO R NASCIMENTO,,330.0,0.0,13453.5,INTER,Receita com serviços,Outras,../data/raw/BANCO INTER-2022.xlsx
2022-06-02,PIX RECEBIDO RAFAEL LESSA CAMPOS CARVALHO,,270.0,0.0,13723.5,INTER,Receita com serviços,Outras,../data/raw/BANCO INTER-2022.xlsx
2022-06-02,PIX RECEBIDO NADIA NAIR LOPES BRASCHER,,180.0,0.0,13903.5,INTER,Receita com serviços,Outras,../data/raw/BANCO INTER-2022.xlsx
2022-06-03,PIX ENVIADO BEATRIZ - PAGTO TERCEIRO,,0.0,384.31,13519.19,INTER,Despesa com pessoal,Salário,../data/raw/BANCO INTER-2022.xlsx
2022-06-06,PIX ENVIADO TATYANA CHAVIER - PAGTO SALÁRIO,,0.0,1858.5,11660.69,INTER,Despesa com pessoal,Salário,../data/raw/BANCO INTER-2022.xlsx
2022-06-06,PIX ENVIADO FERNANDA MARQUES CARBONE - PAGTO SALÁRIO,,0.0,1584.35,10076.34,INTER,Despesa com pessoal,Salário,../data/raw/BANCO INTER-2022.xlsx
2022-06-06,PIX ENVIADO CLAUDIO VINICIUS GALINDO - PAGTO PRO-LABORE,,0.0,1078.68,8997.66,INTER,Despesa com pessoal,Pró labore,../data/raw/BANCO INTER-2022.xlsx
2022-06-06,PIX ENVIADO LUIZ GUSTAVO DA SILVA - PAGTO SALÁRIO,,0.0,1449.85,7547.81,INTER,Despesa com pessoal,Salário,../data/raw/BANCO INTER-2022.xlsx
2022-06-06,PIX RECEBIDO ERIK MARQUES SCHROEDER,,40.0,0.0,7587.81,INTER,Receita com serviços,Outras,../data/raw/BANCO INTER-2022.xlsx
2022-06-08,PIX RECEBIDO RAUL ALBERTO BOCCO,,410.0,0.0,7997.81,INTER,Receita com serviços,Outras,../data/raw/BANCO INTER-2022.xlsx
2022-06-08,PIX RECEBIDO ANDREA FARIAS DE CARVALHO SANTOS,,330.0,0.0,8327.81,INTER,Receita com serviços,Outras,../data/raw/BANCO INTER-2022.xlsx
2022-06-08,PIX RECEBIDO MARINA FRANZON CHINI,,60.0,0.0,8387.81,INTER,Receita com serviços,Outras,../data/raw/BANCO INTER-2022.xlsx
2022-06-08,PIX RECEBIDO ANDERSON MEDEIROS,,280.0,0.0,8667.81,INTER,Receita com serviços,Outras,../data/raw/BANCO INTER-2022.xlsx
2022-06-08,PIX RECEBIDO LUCIENE DE CAMPOS SOUZA,,270.0,0.0,8937.81,INTER,Receita com serviços,Outras,../data/raw/BANCO INTER-2022.xlsx
2022-06-09,COMPRA MERCADO ZAMPROGNA,,0.0,121.39,8816.42,INTER,Despesa com produtos,Outras,../data/raw/BANCO INTER-2022.xlsx
2022-06-09,PIX ENVIADO MAESTRELLI & FERRO,,0.0,80.0,8736.42,INTER,Despesas administrativas,Manutenção predial,../data/raw/BANCO INTER-2022.xlsx
2022-06-10,PIX RECEBIDO DORACI BAITALA POLLI,,180.0,0.0,8916.42,INTER,Receita com serviços,Outras,../data/raw/BANCO INTER-2022.xlsx
2022-06-10,PIX RECEBIDO LK2 PROD E EVENTOS LTDA ME,,400.0,0.0,9316.42,INTER,Receita com serviços,Outras,../data/raw/BANCO INTER-2022.xlsx
2022-06-10,PIX RECEBIDO PRISCILA GUTERRES PRESTES,,445.0,0.0,9761.42,INTER,Receita com serviços,Outras,../data/raw/BANCO INTER-2022.xlsx
2022-06-13,PIX RECEBIDO JINNAH HAN,,410.0,0.0,10171.42,INTER,Receita com serviços,Outras,../data/raw/BANCO INTER-2022.xlsx
2022-06-13,COMPRA CARTÃO ALBATRONIC CURITIBA,,0.0,223.5,9947.92,INTER,Despesa com produtos,Outras,../data/raw/BANCO INTER-2022.xlsx
2022-06-13,PIX RECEBIDO ANA CLAUDIA BORCATH DE ANDRADE TOMITA,,300.0,0.0,10247.92,INTER,Receita com serviços,Outras,../data/raw/BANCO INTER-2022.xlsx
2022-06-13,PIX RECEBIDO MARIA LINA MORATELLI PRADO,,410.0,0.0,10657.92,INTER,Receita com serviços,Outras,../data/raw/BANCO INTER-2022.xlsx
2022-06-14,PIX RECEBIDO RICARDO LUIZ DA SILVA,,40.0,0.0,10697.92,INTER,Receita com serviços,Outras,../data/raw/BANCO INTER-2022.xlsx
2022-06-14,PIX RECEBIDO CLAUDIO VICTOR CAMURCA LIMA,,85.0,0.0,10782.92,INTER,Receita com serviços,Outras,../data/raw/BANCO INTER-2022.xlsx
2022-06-15,PIX RECEBIDO EDUINO GABARDO FILHO,,640.0,0.0,11422.92,INTER,Receita com serviços,Outras,../data/raw/BANCO INTER-2022.xlsx
2022-06-15,PIX ENVIADO THIAGO IANUCH MARIN,,0.0,817.0,10605.92,INTER,Despesa com pessoal,Salário,../data/raw/BANCO INTER-2022.xlsx
2022-06-20,PIX ENVIADO RAMON - ADIANTAMENTO DE SALÁRIO,,0.0,1080.0,9525.92,INTER,Despesa com pessoal,Salário,../data/raw/BANCO INTER-2022.xlsx
2022-06-20,PAGAMENTO FATURA CARTÃO INTER,,0.0,1919.56,7606.36,INTER,Despesas administrativas,Outras,../data/raw/BANCO INTER-2022.xlsx
2022-06-20,PIX RECEBIDO FRANCISCO STEPIEN,,195.0,0.0,7801.36,INTER,Receita com serviços,Outras,../data/raw/BANCO INTER-2022.xlsx
2022-06-20,PIX RECEBIDO GABRIELLE CRISTINA GASPARIN,,480.0,0.0,8281.36,INTER,Receita com serviços,Outras,../data/raw/BANCO INTER-2022.xlsx
2022-06-20,PIX RECEBIDO MAURI JOSE DE SOUZA,,200.0,0.0,5481.36,INTER,Receita com serviços,Outras,../data/raw/BANCO INTER-2022.xlsx
2022-06-20,PIX RECEBIDO CLEIA DO ROCIO BUSS CAMARGO,,1350.0,0.0,9831.36,INTER,Receita com serviços,Outras,../data/raw/BANCO INTER-2022.xlsx
2022-06-21,PIX RECEBIDO ANDERSON RICARDO COSTA,,75.0,0.0,9906.36,INTER,Receita com serviços,Outras,../data/raw/BANCO INTER-2022.xlsx
2022-06-21,PIX RECEBIDO PLATINOX COMERCIO DE EQUIPAMENTOS,,480.0,0.0,10386.36,INTER,Receita com serviços,Outras,../data/raw/BANCO INTER-2022.xlsx
2022-06-21,PIX RECEBIDO ANDRE ALEXANDRE FORT,,180.0,0.0,10566.36,INTER,Receita com serviços,Outras,../data/raw/BANCO INTER-2022.xlsx
2022-06-21,CASHBACK CARTAO DE CREDITO,,4.79,0.0,10571.15,INTER,Receitas financeiras,Outras,../data/raw/BANCO INTER-2022.xlsx
2022-06-22,PIX RECEBIDO ROSELENE MARIA SCHNEIDER,,175.0,0.0,10746.15,INTER,Receita com serviços,Outras,../data/raw/BANCO INTER-2022.xlsx
2022-06-22,PIX RECEBIDO BRANCA PETERSEN JARDIM,,54.0,0.0,10800.15,INTER,Receita com serviços,Outras,../data/raw/BANCO INTER-2022.xlsx
2022-06-22,PIX ENVIADO RAMON - COMPRA DE PEÇA RELÊ NFC-e 54168-GIRELLI,,0.0,93.0,10707.15,INTER,Despesa com serviços,Peças,../data/raw/BANCO INTER-2022.xlsx
2022-06-23,COMPRA CARTAO BALAROTI - NFC-e 96408,,0.0,33.64,10673.51,INTER,Despesa com produtos,Outras,../data/raw/BANCO INTER-2022.xlsx
2022-06-24,PIX RECEBIDO DANIEL RODRIGUES MOCELIN,,270.0,0.0,10943.51,INTER,Receita com serviços,Outras,../data/raw/BANCO INTER-2022.xlsx
2022-06-24,PIX RECEBIDO ALEXSANDRA DOMBEKET MACANHAN,,50.0,0.0,10993.51,INTER,Receita com serviços,Outras,../data/raw/BANCO INTER-2022.xlsx
2022-06-24,COMPRA CARTÃO LOJAS DO PEDRO,,0.0,55.0,10938.51,INTER,Despesa com produtos,Outras,../data/raw/BANCO INTER-2022.xlsx
2022-06-27,PIX ENVIADO RAMON - PAGTO COMBUSTÍVEL MOTO,,0.0,35.0,10903.51,INTER,Despesas administrativas,Combustivel,../data/raw/BANCO INTER-2022.xlsx
2022-06-27,PIX RECEBIDO GUILHERME GOMES FERREIRA,,60.0,0.0,10963.51,INTER,Receita com serviços,Outras,../data/raw/BANCO INTER-2022.xlsx
2022-06-28,PIX RECEBIDO MATEUS MEDEIRO FRANCISCO,,70.0,0.0,11033.51,INTER,Receita com serviços,Outras,../data/raw/BANCO INTER-2022.xlsx
2022-07-01,PIX RECEBIDO VIRGINIA PASSOS MARTINS,,90.0,0.0,11123.51,INTER,Receita com serviços,Outras,../data/raw/BANCO INTER-2022.xlsx
2022-07-04,PIX RECEBIDO CESAR HENRIQUE M CORDEIRO,,27.5,0.0,11151.01,INTER,Receita com serviços,Outras,../data/raw/BANCO INTER-2022.xlsx
2022-07-04,PIX RECEBIDO MATEUS MARTINS CALETTI,,270.0,0.0,11421.01,INTER,Receita com serviços,Outras,../data/raw/BANCO INTER-2022.xlsx
2022-07-04,PAGAMENTO DE CONVÊNIO-GOVERNO DO PARANA SECRETARIA DE ESTADO-GRPR,,0.0,351.48,11069.53,INTER,Despesas tributárias ,Outras,../data/raw/BANCO INTER-2022.xlsx
2022-07-04,PIX RECEBIDO ELOIZA MARIA ALVES DA SILVA,,160.0,0.0,11229.53,INTER,Receita com serviços,Outras,../data/raw/BANCO INTER-2022.xlsx
2022-07-04,PIX ENVIADO ALINE - DEVOLUÇÃO,,0.0,43.46,11186.07,INTER,Transferência (Débito),Transferência / Reembolso,../data/raw/BANCO INTER-2022.xlsx
2022-07-05,PIX RECEBIDO RENATO RIEDI SOUZA MACEDO,,350.0,0.0,11536.07,INTER,Receita com serviços,Outras,../data/raw/BANCO INTER-2022.xlsx
2022-07-06,PIX RECEBIDO JEFERSON ANTONIO BART,,37.5,0.0,11573.57,INTER,Receita com serviços,Outras,../data/raw/BANCO INTER-2022.xlsx
2022-07-06,PIX RECEBIDO HELOISA DALLANHOL,,70.0,0.0,11643.57,INTER,Receita com serviços,Outras,../data/raw/BANCO INTER-2022.xlsx
2022-07-06,PIX ENVIADO TATYANA CHAVIER - PAGTO SALÁRIO,,0.0,1835.38,9808.19,INTER,Despesa com pessoal,Salário,../data/raw/BANCO INTER-2022.xlsx
2022-07-06,PIX ENVIADO LUIZ GUSTAVO DA SILVA - PAGTO SALÁRIO,,0.0,1369.26,8438.93,INTER,Despesa com pessoal,Salário,../data/raw/BANCO INTER-2022.xlsx
2022-07-06,PIX ENVIADO CLAUDIO - PAGTO PRÓ-LABORE,,0.0,1078.68,7360.25,INTER,Despesa com pessoal,Pró labore,../data/raw/BANCO INTER-2022.xlsx
2022-07-06,PIX ENVIADO RAMON PEREIRA DE OLIVEIRA - PAGTO SALÁRIO,,0.0,1417.6,5942.65,INTER,Despesa com pessoal,Salário,../data/raw/BANCO INTER-2022.xlsx
2022-07-06,PIX RECEBIDO WANDERLEA PLEBANI,,60.0,0.0,6002.65,INTER,Receita com serviços,Outras,../data/raw/BANCO INTER-2022.xlsx
2022-07-07,PIX RECEBIDO INVANETE BATISTA CEZAR,,360.0,0.0,6362.65,INTER,Receita com serviços,Outras,../data/raw/BANCO INTER-2022.xlsx
2022-07-07,PIX RECEBIDO SYLUS CONTRUTORA E INCORPORADORA LTDA,,280.0,0.0,6642.65,INTER,Receita com serviços,Outras,../data/raw/BANCO INTER-2022.xlsx
2022-07-08,PIX RECEBIDO FRANCISCO PAULO RODRIGUES KOZOVITS,,500.0,0.0,7142.65,INTER,Receita com serviços,Outras,../data/raw/BANCO INTER-2022.xlsx
2022-07-11,PIX RECEBIDO VANESSA TAIS NOZAKI,,180.0,0.0,7322.65,INTER,Receita com serviços,Outras,../data/raw/BANCO INTER-2022.xlsx
2022-07-11,PIX RECEBIDO LISIANE ROSAT OSORIO,,270.0,0.0,7592.65,INTER,Receita com serviços,Outras,../data/raw/BANCO INTER-2022.xlsx
2022-07-11,PIX RECEBIDO RODRIGO DOMIT LUSA,,37.5,0.0,7630.15,INTER,Receita com serviços,Outras,../data/raw/BANCO INTER-2022.xlsx
2022-07-12,PIX RECEBIDO ALAN TRISOTTO,,410.0,0.0,8040.15,INTER,Receita com serviços,Outras,../data/raw/BANCO INTER-2022.xlsx
2022-07-12,PIX RECEBIDO DEBORA PATRICIA COSTA XAVIER,,360.0,0.0,8400.15,INTER,Receita com serviços,Outras,../data/raw/BANCO INTER-2022.xlsx
2022-07-13,PIX RECEBIDO DAIANE CRISTINA JUNG,,210.0,0.0,8610.15,INTER,Receita com serviços,Outras,../data/raw/BANCO INTER-2022.xlsx
2022-07-13,PIX RECEBIDO ISMAEL HENRIQUE MENEZES DIAS,,410.0,0.0,9020.15,INTER,Receita com serviços,Outras,../data/raw/BANCO INTER-2022.xlsx
2022-07-14,PIX RECEBIDO KAUANA SAAD NEGREIROS ,,70.0,0.0,9090.15,INTER,Receita com serviços,Outras,../data/raw/BANCO INTER-2022.xlsx
2022-07-14,COMPRA CARTÃO WORKCELL CURITIBA,,0.0,280.0,8810.15,INTER,Despesa com produtos,Outras,../data/raw/BANCO INTER-2022.xlsx
2022-07-18,PIX RECEBIDO STELA REGINA FISCHER,,250.0,0.0,9060.15,INTER,Receita com serviços,Outras,../data/raw/BANCO INTER-2022.xlsx
2022-07-18,PIX RECEBIDO ANDERSON RANDY MACIEL ARAUJO DE OLIVE,,80.0,0.0,9140.15,INTER,Receita com serviços,Outras,../data/raw/BANCO INTER-2022.xlsx
2022-07-18,PIX RECEBIDO JEFERSON ANTONIO BART,,37.5,0.0,4177.65,INTER,Receita com serviços,Outras,../data/raw/BANCO INTER-2022.xlsx
2022-07-18,PIX RECEBIDO JOSE BONIFACIO DA ROCHA,,30.0,0.0,9207.65,INTER,Receita com serviços,Outras,../data/raw/BANCO INTER-2022.xlsx
2022-07-18,PIX RECEBIDO ALESSANDRO DE MIRANDA CAMARGO,,120.0,0.0,9327.65,INTER,Receita com serviços,Outras,../data/raw/BANCO INTER-2022.xlsx
2022-07-18,PIX RECEBIDO MARIANGELA GASSEN,,150.0,0.0,9477.65,INTER,Receita com serviços,Outras,../data/raw/BANCO INTER-2022.xlsx
2022-07-18,PIX RECEBIDO AGOSTINHO DOS SANTOS LISBOA,,340.0,0.0,9817.65,INTER,Receita com serviços,Outras,../data/raw/BANCO INTER-2022.xlsx
2022-07-19,PIX RECEBIDO MAITE MENDES SOARES SIQUEIRA,,144.0,0.0,9961.65,INTER,Receita com serviços,Outras,../data/raw/BANCO INTER-2022.xlsx
2022-07-19,PIX RECEBIDO LUCIANO PEREIRA,,350.0,0.0,10311.65,INTER,Receita com serviços,Outras,../data/raw/BANCO INTER-2022.xlsx
2022-07-19,PIX RECEBIDO SUZANA APARECIDA CERON GONCALV,,390.0,0.0,10701.65,INTER,Receita com serviços,Outras,../data/raw/BANCO INTER-2022.xlsx
2022-07-21,PIX RECEBIDO RODRIGO DE ARAUJO LANTYER DUARTE,,240.0,0.0,10941.65,INTER,Receita com serviços,Outras,../data/raw/BANCO INTER-2022.xlsx
2022-07-21,COMPRA CARTÃO PANIFICADORAXAXIM ,,0.0,52.7,10888.95,INTER,Despesa com produtos,Outras,../data/raw/BANCO INTER-2022.xlsx
2022-07-21,PIX RECEBIDO JONATHAN OLIVEIRA DA SILVA,,456.0,0.0,11344.95,INTER,Receita com serviços,Outras,../data/raw/BANCO INTER-2022.xlsx
2022-07-21,PIX ENVIADO ROBSON - COMPRA DE LIXAS,,0.0,6.45,11338.5,INTER,Despesa com produtos,Outras,../data/raw/BANCO INTER-2022.xlsx
2022-07-21,PIX RECEBIDO BRENO ROLINDO LARA MOREIRA,,125.0,0.0,11463.5,INTER,Receita com serviços,Outras,../data/raw/BANCO INTER-2022.xlsx
2022-07-22,PIX RECEBIDO CAROLINA CHAVES HAUER,,180.0,0.0,11643.5,INTER,Receita com serviços,Outras,../data/raw/BANCO INTER-2022.xlsx
2022-07-22,CASHBACK CARTAO DE CRÉDITO,,5.25,0.0,11648.75,INTER,Receitas financeiras,Outras,../data/raw/BANCO INTER-2022.xlsx
2022-07-25,PIX RECEBIDO EDILSON BETIOL DA SILVA,,90.0,0.0,11738.75,INTER,Receita com serviços,Outras,../data/raw/BANCO INTER-2022.xlsx
2022-07-25,PIX RECEBIDO INVANETE BATISTA CEZAR,,75.0,0.0,11813.75,INTER,Receita com serviços,Outras,../data/raw/BANCO INTER-2022.xlsx
2022-07-25,PIX RECEBIDO JOEL CLAUDIO STADLER,,70.0,0.0,11883.75,INTER,Receita com serviços,Outras,../data/raw/BANCO INTER-2022.xlsx
2022-07-26,COMPRA CARTÃO NITRO FORT NF 8.157,,0.0,260.0,11623.75,INTER,Despesa com produtos,Outras,../data/raw/BANCO INTER-2022.xlsx
2022-07-26,PIX RECEBIDO VIVA TRANSPORTES LTDA ME,,640.0,0.0,12263.75,INTER,Receita com serviços,Outras,../data/raw/BANCO INTER-2022.xlsx
2022-07-26,PIX RECEBIDO MARCEL BRENE DOS SANTOS,,90.0,0.0,12353.75,INTER,Receita com serviços,Outras,../data/raw/BANCO INTER-2022.xlsx
2022-07-27,COMPRA CARTÃO IGOR WILLIAN ,,0.0,40.8,12312.95,INTER,Despesa com produtos,Outras,../data/raw/BANCO INTER-2022.xlsx
2022-07-27,PIX RECEBIDO ANA ELISA FILIZOLA,,180.0,0.0,12492.95,INTER,Receita com serviços,Outras,../data/raw/BANCO INTER-2022.xlsx
2022-07-29,PIX ENVIADO AG DE CORREIOS FRANQUEADA SANTA QUITE,,0.0,74.9,12418.05,INTER,Despesas administrativas,Outras,../data/raw/BANCO INTER-2022.xlsx
2022-08-01,PIX RECEBIDO CINTIA KOEHLER,,35.0,0.0,12453.05,INTER,Receita com serviços,Outras,../data/raw/BANCO INTER-2022.xlsx
2022-08-01,COMPRA COM CARTÃO  CARREFOUR CWP 54 ,,0.0,56.95,12396.1,INTER,Despesa com produtos,Outras,../data/raw/BANCO INTER-2022.xlsx
2022-08-02,PIX RECEBIDO JOZIENY BALBINO,,45.0,0.0,12441.1,INTER,Receita com serviços,Outras,../data/raw/BANCO INTER-2022.xlsx
2022-08-02,PIX ENVIADO THIAGO CORREA - PAGTO DE FRETE REFRIGERADOR,,0.0,100.0,12341.1,INTER,Despesa com serviços,Transporte,../data/raw/BANCO INTER-2022.xlsx
2022-08-02,PIX RECEBIDO LIVIA SORRENTINO BASSI,,230.0,0.0,12571.1,INTER,Receita com serviços,Outras,../data/raw/BANCO INTER-2022.xlsx
2022-08-02,PAGAMENTO DE CONVÊNIO-GOVERNO DO PARANA SECRETARIA DE ESTADO-GRPR,,0.0,68.18,12502.92,INTER,Despesas tributárias ,Outras,../data/raw/BANCO INTER-2022.xlsx
2022-08-03,PIX RECEBIDO SUELI MAZZER RENBERG,,290.0,0.0,12792.92,INTER,Receita com serviços,Outras,../data/raw/BANCO INTER-2022.xlsx
2022-08-03,PIX ENVIADO MARKETPLACE NF-e 011.615,,0.0,85.4,12707.52,INTER,Despesa com serviços,Outras,../data/raw/BANCO INTER-2022.xlsx
2022-08-03,COMPRA COM CARTÃO  SUPER PRO - NF 11.029,,0.0,125.15,12582.37,INTER,Despesa com produtos,Outras,../data/raw/BANCO INTER-2022.xlsx
2022-08-04,PIX RECEBIDO MILTON MASATO FUKUNISHI,,100.0,0.0,12682.37,INTER,Receita com serviços,Outras,../data/raw/BANCO INTER-2022.xlsx
2022-08-04,PIX RECEBIDO MARCOS GARANHAO DE PAULA,,120.0,0.0,12802.37,INTER,Receita com serviços,Outras,../data/raw/BANCO INTER-2022.xlsx
2022-08-04,PIX RECEBIDO LUIZ GUSTAVO DA SILVA,,35.0,0.0,12837.37,INTER,Receita com serviços,Outras,../data/raw/BANCO INTER-2022.xlsx
2022-08-05,PIX RECEBIDO NICOLAY ALEXANDRE CERKUNVIS,,175.0,0.0,13012.37,INTER,Receita com serviços,Outras,../data/raw/BANCO INTER-2022.xlsx
2022-08-05,PIX ENVIADO TATYANA CHAVIER - PAGTO DE SALÁRIO,,0.0,1053.39,11958.98,INTER,Despesa com pessoal,Salário,../data/raw/BANCO INTER-2022.xlsx
2022-08-05,PIX ENVIADO RAMON P. DE OLIVEIRA - PAGTO DE SALÁRIO,,0.0,1510.75,10448.23,INTER,Despesa com pessoal,Salário,../data/raw/BANCO INTER-2022.xlsx
2022-08-05,PIX ENVIADO ELISABETE - PAGTO PRO-LABORE,,0.0,1078.68,9369.55,INTER,Despesa com pessoal,Pró labore,../data/raw/BANCO INTER-2022.xlsx
2022-08-05,PIX ENVIADO CLAUDIO - PAGTO PRO-LABORE,,0.0,1078.68,8290.87,INTER,Despesa com pessoal,Pró labore,../data/raw/BANCO INTER-2022.xlsx
2022-08-05,PIX ENVIADO GUILHERME - PAGTO DE TERCEIROS,,0.0,472.5,7818.37,INTER,Despesa com pessoal,Salário,../data/raw/BANCO INTER-2022.xlsx
2022-08-05,PIX RECEBIDO ANA PAULA FONSECA,,120.0,0.0,7938.37,INTER,Receita com serviços,Outras,../data/raw/BANCO INTER-2022.xlsx
2022-08-05,PIX RECEBIDO PAULA DE ALMEIDA ASSAD,,180.0,0.0,8118.37,INTER,Receita com serviços,Outras,../data/raw/BANCO INTER-2022.xlsx
2022-08-08,PIX RECEBIDO CAROLINA TAVARES PEREIRA,,160.0,0.0,8278.37,INTER,Receita com serviços,Outras,../data/raw/BANCO INTER-2022.xlsx
2022-08-10,PIX RECEBIDO DANIEL C WIEDEMANN,,345.0,0.0,8623.37,INTER,Receita com serviços,Outras,../data/raw/BANCO INTER-2022.xlsx
2022-08-10,PIX ENVIADO RAMON - REF. NF 114359 SPRINGER CARRIER,,0.0,38.75,8584.62,INTER,Despesa com serviços,Outras,../data/raw/BANCO INTER-2022.xlsx
2022-08-10,COMPRA CARTÃO PARAFUSOS CURITIBA,,0.0,11.0,8573.62,INTER,Despesa com serviços,Peças,../data/raw/BANCO INTER-2022.xlsx
2022-08-11,PIX RECEBIDO BIANCA RAMOS ROCHA DE OLIVEIRA,,70.0,0.0,8643.62,INTER,Receita com serviços,Outras,../data/raw/BANCO INTER-2022.xlsx
2022-08-11,PIX RECEBIDO LIVIA SORRENTINO BASSI,,30.0,0.0,8673.62,INTER,Receita com serviços,Outras,../data/raw/BANCO INTER-2022.xlsx
2022-08-11,PIX RECEBIDO DENIZE DE PAULA NEVES ARANTES,,475.0,0.0,9148.62,INTER,Receita com serviços,Outras,../data/raw/BANCO INTER-2022.xlsx
2022-08-11,PIX RECEBIDO CAROLINA TAVARES PEREIRA,,60.0,0.0,9208.62,INTER,Receita com serviços,Outras,../data/raw/BANCO INTER-2022.xlsx
2022-08-11,PIX RECEBIDO JOÃO ANTONIO C I FILGUEIRA,,200.0,0.0,9408.62,INTER,Receita com serviços,Outras,../data/raw/BANCO INTER-2022.xlsx
2022-08-11,PIX RECEBIDO SADI EUGENIO DE SOUZA JUNIOR,,280.0,0.0,9688.62,INTER,Receita com serviços,Outras,../data/raw/BANCO INTER-2022.xlsx
2022-08-12,PIX ENVIADO RAMON P/ PAGTO GASOLINA P/ MOTO,,0.0,65.02,9623.6,INTER,Despesas administrativas,Combustivel,../data/raw/BANCO INTER-2022.xlsx
2022-08-12,CDB CREDITO BANCO INTER SA,,0.0,8000.0,1623.6,INTER,Transferência (Débito),Aplicação,../data/raw/BANCO INTER-2022.xlsx
2022-08-15,PIX RECEBIDO ANA FLAVIA MELLO BACCHI RABAY,,170.0,0.0,1793.6,INTER,Receita com serviços,Outras,../data/raw/BANCO INTER-2022.xlsx
2022-08-15,PIX RECEBIDO ALI CHAIM FILHO,,280.0,0.0,2073.6,INTER,Receita com serviços,Outras,../data/raw/BANCO INTER-2022.xlsx
2022-08-15,PIX RECEBIDO ANA FLAVIA MELLO BACCHI RABAY,,18.0,0.0,2091.6,INTER,Receita com serviços,Outras,../data/raw/BANCO INTER-2022.xlsx
2022-08-15,PIX RECEBIDO LEANDRO MARCOS DE LAIA,,130.0,0.0,2221.6,INTER,Receita com serviços,Outras,../data/raw/BANCO INTER-2022.xlsx
2022-08-16,PIX RECEBIDO EDUARDO SALLOUM,,80.0,0.0,2301.6,INTER,Receita com serviços,Outras,../data/raw/BANCO INTER-2022.xlsx
2022-08-16,PIX RECEBIDO SAULO LINDORFER PIVETTA,,180.0,0.0,2481.6,INTER,Receita com serviços,Outras,../data/raw/BANCO INTER-2022.xlsx
2022-08-16,CASHBACK CARTÃO DE CRÉDITO,,7.04,0.0,2488.64,INTER,Receitas financeiras,Outras,../data/raw/BANCO INTER-2022.xlsx
2022-08-17,PIX RECEBIDO INNOVE T P LTDA - ME,,570.0,0.0,3058.64,INTER,Receita com serviços,Outras,../data/raw/BANCO INTER-2022.xlsx
2022-08-17,PIX RECEBIDO MARIA DE LOURDES DE SOUSA LIMA,,350.0,0.0,3408.64,INTER,Receita com serviços,Outras,../data/raw/BANCO INTER-2022.xlsx
2022-08-17,PIX RECEBIDO DANIEL C WIEDEMANN,,380.0,0.0,3788.64,INTER,Receita com serviços,Outras,../data/raw/BANCO INTER-2022.xlsx
2022-08-17,PIX ENVIADO  MARKETPLACE,,0.0,223.71,3564.93,INTER,Despesa com serviços,Outras,../data/raw/BANCO INTER-2022.xlsx
2022-08-18,PAGAMENTO DE TÍTULO ENVELOPE PRA NOTAS FISCAIS,,0.0,90.65,3474.28,INTER,Despesas administrativas,Outras,../data/raw/BANCO INTER-2022.xlsx
2022-08-18,PIX ENVIADO CONCEPTFOUR T C S EIRELI,,0.0,299.25,3175.03,INTER,Despesa com serviços,Outras,../data/raw/BANCO INTER-2022.xlsx
2022-08-18,PIX RECEBIDO JOSE BONIFACIO DA ROCHA,,30.0,0.0,3205.03,INTER,Receita com serviços,Outras,../data/raw/BANCO INTER-2022.xlsx
2022-08-18,PIX RECEBIDO LYBIA S PIMENTEL,,180.0,0.0,3385.03,INTER,Receita com serviços,Outras,../data/raw/BANCO INTER-2022.xlsx
2022-08-19,PIX ENVIADO M&E INFORMATICA LTDA,,0.0,1270.0,2115.03,INTER,Despesa com serviços,Outras,../data/raw/BANCO INTER-2022.xlsx
2022-08-19,PIX ENVIADO BALAROTI,,0.0,235.56,1879.47,INTER,Despesa com serviços,Outras,../data/raw/BANCO INTER-2022.xlsx
2022-08-19,PIX RECEBIDO BRUNO PUTZ,,422.82,0.0,2302.29,INTER,Receita com serviços,Outras,../data/raw/BANCO INTER-2022.xlsx
2022-08-19,PIX RECEBIDO DANIELA PINHEIRO ESPINDOLA,,115.0,0.0,2417.29,INTER,Receita com serviços,Outras,../data/raw/BANCO INTER-2022.xlsx
2022-08-22,PIX RECEBIDO NICOLAS IRINEU TEIXEIRA,,835.0,0.0,3252.29,INTER,Receita com serviços,Outras,../data/raw/BANCO INTER-2022.xlsx
2022-08-22,PIX RECEBIDO JESSICA SANT ANNA LOPEZ,,255.0,0.0,3507.29,INTER,Receita com serviços,Outras,../data/raw/BANCO INTER-2022.xlsx
2022-08-22,PIX RECEBIDO ELAINE CRISTINA DE ALMEIDA FERREIRA,,100.0,0.0,3607.29,INTER,Receita com serviços,Outras,../data/raw/BANCO INTER-2022.xlsx
2022-08-22,PIX RECEBIDO ALMERI PAULO FINGER,,300.0,0.0,3907.29,INTER,Receita com serviços,Outras,../data/raw/BANCO INTER-2022.xlsx
2022-08-23,PIX RECEBIDO EDIANE ALINE VATER,,255.0,0.0,4162.29,INTER,Receita com serviços,Outras,../data/raw/BANCO INTER-2022.xlsx
2022-08-23,PIX RECEBIDO VINICIUS CARLOS RUFINO,,390.0,0.0,4552.29,INTER,Receita com serviços,Outras,../data/raw/BANCO INTER-2022.xlsx
2022-08-23,PIX RECEBIDO RENATA JUNQUEIRA DE VIVEIROS,,150.0,0.0,4702.29,INTER,Receita com serviços,Outras,../data/raw/BANCO INTER-2022.xlsx
2022-08-24,PIX RECEBIDO ANA ELISA FILIZOLA,,180.0,0.0,4882.29,INTER,Receita com serviços,Outras,../data/raw/BANCO INTER-2022.xlsx
2022-08-24,PIX RECEBIDO CESAR ALEXANDRE FERREIRA,,270.0,0.0,5152.29,INTER,Receita com serviços,Outras,../data/raw/BANCO INTER-2022.xlsx
2022-08-24,PIX RECEBIDO ROBSON GUTIERREZ,,250.0,0.0,5402.29,INTER,Receita com serviços,Outras,../data/raw/BANCO INTER-2022.xlsx
2022-08-24,PIX ENVIADO LEO MOTOS - PEÇAS E REVISÃO,,0.0,430.0,4972.29,INTER,Despesas administrativas,Peças/acessórios veiculos,../data/raw/BANCO INTER-2022.xlsx
2022-08-25,PIX RECEBIDO MOISES DE OLIVEIRA MORAIS ,,1050.0,0.0,6022.29,INTER,Receita com serviços,Outras,../data/raw/BANCO INTER-2022.xlsx
2022-08-25,COMPRA C/ CARTÃO ZAMPROGNA,,0.0,145.28,5877.01,INTER,Despesa com produtos,Outras,../data/raw/BANCO INTER-2022.xlsx
2022-08-25,PIX RECEBIDO IMOBILIARIA TN SILVA LTDA,,150.0,0.0,6027.01,INTER,Receita com serviços,Outras,../data/raw/BANCO INTER-2022.xlsx
2022-08-26,PIX RECEBIDO DEBORA MEYER TOLEDO,,40.0,0.0,6067.01,INTER,Receita com serviços,Outras,../data/raw/BANCO INTER-2022.xlsx
2022-08-26,PIX RECEBIDO LPC RESTAURANTE EIRELI,,600.0,0.0,6667.01,INTER,Receita com serviços,Outras,../data/raw/BANCO INTER-2022.xlsx
2022-08-26,PIX RECEBIDO RADHA MOVEIS E DECORAÇÃO LTDA,,175.0,0.0,6842.01,INTER,Receita com serviços,Outras,../data/raw/BANCO INTER-2022.xlsx
2022-08-29,PIX RECEBIDO MLG REFEICOES LTDA ME,,100.0,0.0,6942.01,INTER,Receita com serviços,Outras,../data/raw/BANCO INTER-2022.xlsx
2022-08-29,PIX RECEBIDO LEONARDO FUZI,,50.0,0.0,6992.01,INTER,Receita com serviços,Outras,../data/raw/BANCO INTER-2022.xlsx
2022-08-29,APLICAÇÃO CDB CREDITO BACO INTER,,0.0,3000.0,3992.01,INTER,Despesas financeiras,Aplicação,../data/raw/BANCO INTER-2022.xlsx
2022-08-29,PIX RECEBIDO HELAINE ROSA SAAB,,375.0,0.0,4367.01,INTER,Receita com serviços,Outras,../data/raw/BANCO INTER-2022.xlsx
2022-08-29,PIX RECEBIDO RAFAEL DE MORAES OLIVEIRA & CIA LTDA,,60.0,0.0,4427.01,INTER,Receita com serviços,Outras,../data/raw/BANCO INTER-2022.xlsx
2022-08-30,PIX RECEBIDO JESSICA SANT ANNA LOPEZ,,535.0,0.0,4962.01,INTER,Receita com serviços,Outras,../data/raw/BANCO INTER-2022.xlsx
2022-08-30,PIX RECEBIDO MARCIA REGINA CORREIA,,150.0,0.0,5112.01,INTER,Receita com serviços,Outras,../data/raw/BANCO INTER-2022.xlsx
2022-08-31,PIX RECEBIDO ERIC DE OLIVEIRA CLEVE GOES,,180.0,0.0,5292.01,INTER,Receita com serviços,Outras,../data/raw/BANCO INTER-2022.xlsx
2022-08-31,PIX RECEBIDO LAIS EMANUELI QUINTINO NODA,,40.0,0.0,5332.01,INTER,Receita com serviços,Outras,../data/raw/BANCO INTER-2022.xlsx
2022-09-01,PIX RECEBIDO MARCIO BUSS VOLPATO,,80.0,0.0,5412.01,INTER,Receita com serviços,Outras,../data/raw/BANCO INTER-2022.xlsx
2022-09-01,PIX RECEBIDO REGIAN CANUTO DOS SANTOS,,150.0,0.0,5562.01,INTER,Receita com serviços,Outras,../data/raw/BANCO INTER-2022.xlsx
2022-09-01,PIX RECEBIDO LARISSA DA ROSA DOS REIS,,200.0,0.0,5762.01,INTER,Receita com serviços,Outras,../data/raw/BANCO INTER-2022.xlsx
2022-09-02,PIX RECEBIDO JOSE R A CAMARGO ANDRADE,,220.0,0.0,5982.01,INTER,Receita com serviços,Outras,../data/raw/BANCO INTER-2022.xlsx
2022-09-02,PIX RECEBIDO SYLUS CONTRUTORA E INCORPORADORA LTDA,,265.0,0.0,6247.01,INTER,Receita com serviços,Outras,../data/raw/BANCO INTER-2022.xlsx
2022-09-02,PIX RECEBIDO TECNOLOGBR LOGISTICA E TRANSPORTES LT,,1140.0,0.0,7387.01,INTER,Receita com serviços,Outras,../data/raw/BANCO INTER-2022.xlsx
2022-09-02,PIX RECEBIDO EDUARDO RODRIGUES GUIMARÃES,,60.0,0.0,7447.01,INTER,Receita com serviços,Outras,../data/raw/BANCO INTER-2022.xlsx
2022-09-02,PIX RECEBIDO RENATO BARCE ANTUNES,,280.0,0.0,7727.01,INTER,Receita com serviços,Outras,../data/raw/BANCO INTER-2022.xlsx
2022-09-02,PIX ENVIADO MAESTRELLI & FERRO FORNECIMENTO DE AL,,0.0,73.9,7653.11,INTER,Despesas administrativas,Manutenção predial,../data/raw/BANCO INTER-2022.xlsx
2022-09-06,PIX RECEBIDO RAFAEL PAULO BRIXEL,,345.0,0.0,7998.11,INTER,Receita com serviços,Outras,../data/raw/BANCO INTER-2022.xlsx
2022-09-06,PIX ENVIADO TATYANA CHAVIER - PAGTO DE SALÁRIO,,0.0,1491.53,6506.58,INTER,Despesa com pessoal,Salário,../data/raw/BANCO INTER-2022.xlsx
2022-09-06,PIX ENVIADO CLAUDIO - PAGTO PRO-LABORE,,0.0,1078.68,5427.9,INTER,Despesa com pessoal,Pró labore,../data/raw/BANCO INTER-2022.xlsx
2022-09-06,PIX ENVIADO RAMON PEREIRA DE OLIVEIRA - PAGTO DE SALÁRIO,,0.0,1577.72,3850.18,INTER,Despesa com pessoal,Salário,../data/raw/BANCO INTER-2022.xlsx
2022-09-06,PIX RECEBIDO SUL ALIMENTOS COM DE PRODUTOS ALIMENTICIOS,,360.0,0.0,4210.18,INTER,Receita com serviços,Outras,../data/raw/BANCO INTER-2022.xlsx
2022-09-06,PIX RECEBIDO CLISLEI MARQUES DA SILVA,,352.0,0.0,4562.18,INTER,Receita com serviços,Outras,../data/raw/BANCO INTER-2022.xlsx
2022-09-09,PIX ENVIADO IFOOD.COM AGENCIA DE RESTAURANTES - AT. ON-SITE,,0.0,48.87,4513.31,INTER,Despesa com pessoal,Alimentação (VR VA),../data/raw/BANCO INTER-2022.xlsx
2022-09-09,PIX RECEBIDO MARCOS RAIDAN SILVA,,300.0,0.0,4813.31,INTER,Receita com serviços,Outras,../data/raw/BANCO INTER-2022.xlsx
2022-09-09,PIX RECEBIDO LUCIANA MRZYGLOD,,40.0,0.0,4853.31,INTER,Receita com serviços,Outras,../data/raw/BANCO INTER-2022.xlsx
2022-09-09,PIX RECEBIDO ANA PRENDIN PINHEIRO DE LIMA,,200.0,0.0,5053.31,INTER,Receita com serviços,Outras,../data/raw/BANCO INTER-2022.xlsx
2022-09-13,PIX RECEBIDO ANA PAULA LIMA DA SILVA,,360.0,0.0,5413.31,INTER,Receita com serviços,Outras,../data/raw/BANCO INTER-2022.xlsx
2022-09-13,PIX RECEBIDO SANTUZA MARIA MASCARENHAS LOPES CANCADO,,185.0,0.0,5598.31,INTER,Receita com serviços,Outras,../data/raw/BANCO INTER-2022.xlsx
2022-09-13,PIX RECEBIDO WANIA LUCIA SOUZA,,135.0,0.0,5733.31,INTER,Receita com serviços,Outras,../data/raw/BANCO INTER-2022.xlsx
2022-09-15,PIX RECEBIDO MARAISA CRISTINA PERUZZO,,150.0,0.0,5883.31,INTER,Receita com serviços,Outras,../data/raw/BANCO INTER-2022.xlsx
2022-09-16,PIX ENVIADO DEPARTAMENTO DE TRANSITO DETRAN,,0.0,86.5,5796.81,INTER,Despesas administrativas,Veiculos,../data/raw/BANCO INTER-2022.xlsx
2022-09-16,PIX ENVIADO DEPARTAMENTO DE TRANSITO DETRAN,,0.0,156.18,5640.63,INTER,Despesas administrativas,Veiculos,../data/raw/BANCO INTER-2022.xlsx
2022-09-16,"PIX RECEBIDO ROSICLER ROMERO GODOY
",,270.0,0.0,5910.63,INTER,Receita com serviços,Outras,../data/raw/BANCO INTER-2022.xlsx
2022-09-19,PIX RECEBIDO TCHANO LOCAÇÕES,,200.0,0.0,6110.63,INTER,Receita com serviços,Outras,../data/raw/BANCO INTER-2022.xlsx
2022-09-19,COMPRA CARTÃO CHECKBOX CURITIBA,,0.0,417.5,5693.13,INTER,Despesa com produtos,Outras,../data/raw/BANCO INTER-2022.xlsx
2022-09-19,PIX RECEBIDO JOSEANE RUSCHEL MANCIO,,220.0,0.0,5913.13,INTER,Receita com serviços,Outras,../data/raw/BANCO INTER-2022.xlsx
2022-09-20,PIX RECEBIDO FAAL IND DE ESTOFADOS,,80.0,0.0,5993.13,INTER,Receita com serviços,Outras,../data/raw/BANCO INTER-2022.xlsx
2022-09-20,PIX ENVIADO ROBSON - COMPRA DE FITAS ISOLANTE,,0.0,11.6,5981.53,INTER,Despesa com serviços,Peças,../data/raw/BANCO INTER-2022.xlsx
2022-09-20,PIX ENVIADO COMERCIAL G PAZA MAT DE CONSTRUÇÃO,,0.0,80.5,5901.03,INTER,Despesas administrativas,Manutenção predial,../data/raw/BANCO INTER-2022.xlsx
2022-09-20,PIX RECEBIDO JULIA GODINHO DE ANDRADE,,120.0,0.0,6021.03,INTER,Receita com serviços,Outras,../data/raw/BANCO INTER-2022.xlsx
2022-09-20,PIX RECEBIDO GUILHERME CELESTINO - NFC-e 1757,,200.0,0.0,6221.03,INTER,Receita com serviços,Outras,../data/raw/BANCO INTER-2022.xlsx
2022-09-21,PIX RECEBIDO LUCAS ARAUJO,,290.0,0.0,6511.03,INTER,Receita com serviços,Outras,../data/raw/BANCO INTER-2022.xlsx
2022-09-21,PIX RECEBIDO SALLY FRANCINI ALCANTARA SERCONHUK,,370.0,0.0,6881.03,INTER,Receita com serviços,Outras,../data/raw/BANCO INTER-2022.xlsx
2022-09-21,CASHBACK CARTAO DE CRÉDITO,,7.02,0.0,6888.05,INTER,Receitas financeiras,Outras,../data/raw/BANCO INTER-2022.xlsx
2022-09-22,PIX RECEBIDO LISIANE MARIA TREVIZAN,,80.0,0.0,6968.05,INTER,Receita com serviços,Outras,../data/raw/BANCO INTER-2022.xlsx
2022-09-22,PIX RECEBIDO HIPOLITO SEVERINO DE QUEIROZ LIMA,,60.0,0.0,7028.05,INTER,Receita com serviços,Outras,../data/raw/BANCO INTER-2022.xlsx
2022-09-22,PIX RECEBIDO CARLOS FELIPE PENACHIONI,,90.0,0.0,7118.05,INTER,Receita com serviços,Outras,../data/raw/BANCO INTER-2022.xlsx
2022-09-23,COMPRA CARTÃO MEGA AR STORE NF-e 3.321,,0.0,125.14,6992.91,INTER,Despesa com produtos,Outras,../data/raw/BANCO INTER-2022.xlsx
2022-09-23,PIX RECEBIDO RAFAEL PAULO BRIXEL,,65.0,0.0,7057.91,INTER,Receita com serviços,Outras,../data/raw/BANCO INTER-2022.xlsx
2022-09-23,PIX RECEBIDO CARLA CRISTINA FRANCESCON,,300.0,0.0,7357.91,INTER,Receita com serviços,Outras,../data/raw/BANCO INTER-2022.xlsx
2022-09-26,PIX RECEBIDO DANIELLE RYE HIRANO,,280.0,0.0,7637.91,INTER,Receita com serviços,Outras,../data/raw/BANCO INTER-2022.xlsx
2022-09-26,COMPRA CARTÃO SPRINGER CARRIER NF 115.057,,0.0,13.0,7624.91,INTER,Despesa com produtos,Outras,../data/raw/BANCO INTER-2022.xlsx
2022-09-26,PIX RECEBIDO NEIVA MARIA PILONI,,280.0,0.0,7904.91,INTER,Receita com serviços,Outras,../data/raw/BANCO INTER-2022.xlsx
2022-09-26,PIX RECEBIDO RAFAEL PAULO BRIXEL,,175.0,0.0,8079.91,INTER,Receita com serviços,Outras,../data/raw/BANCO INTER-2022.xlsx
2022-09-26,PIX RECEBIDO AMANDA GARCIA SILVA,,370.0,0.0,8449.91,INTER,Receita com serviços,Outras,../data/raw/BANCO INTER-2022.xlsx
2022-09-27,PIX RECEBIDO CONDOMINIO DOM RODRIGO FLAT SERV - NFS-e 2217 E NF-e 3909,,345.0,0.0,8794.91,INTER,Receita com serviços,Outras,../data/raw/BANCO INTER-2022.xlsx
2022-09-28,PIX RECEBIDO ROSILEIDE DE SOUZA TOGINHO,,85.0,0.0,8879.91,INTER,Receita com serviços,Outras,../data/raw/BANCO INTER-2022.xlsx
2022-09-28,PIX RECEBIDO LETICIA TREVISAN TECCHIO,,430.0,0.0,9309.91,INTER,Receita com serviços,Outras,../data/raw/BANCO INTER-2022.xlsx
2022-10-04,COMPRA CARTÃO RECARGA CELULAR DA ECEEL,,0.0,10.0,9299.91,INTER,Despesas administrativas,"Telefonia (Celular, Fixo, Internet)",../data/raw/BANCO INTER-2022.xlsx
2022-10-04,PIX RECEBIDO HELENA MARIA DA ROCHA,,100.0,0.0,9399.91,INTER,Receita com serviços,Outras,../data/raw/BANCO INTER-2022.xlsx
2022-10-04,PIX RECEBIDO DANIELE SERPA DA SILVEIRA,,47.5,0.0,9447.41,INTER,Receita com serviços,Outras,../data/raw/BANCO INTER-2022.xlsx
2022-10-04,PIX RECEBIDO KARLA NATHALIA DA SILVA PEREIRA,,360.0,0.0,9807.41,INTER,Receita com serviços,Outras,../data/raw/BANCO INTER-2022.xlsx
2022-10-04,PIX RECEBIDO GILBERTO F FELDHAUS,,100.0,0.0,9907.41,INTER,Receita com serviços,Outras,../data/raw/BANCO INTER-2022.xlsx
2022-10-04,PIX ENVIADO DOUGLAS JACOBSEN MARTINS (TROCO),,0.0,20.0,9887.41,INTER,Transferência (Débito),Transferência / Reembolso,../data/raw/BANCO INTER-2022.xlsx
2022-10-04,PIX ENVIADO STAMPAFER (RDW) - NF 29030-21/10/22,,0.0,345.0,9542.41,INTER,Despesa com serviços,Outras,../data/raw/BANCO INTER-2022.xlsx
2022-10-05,PIX RECEBIDO ALESSANDRO ANTONIO DE ALMEIDA ROCHA,,220.0,0.0,9762.41,INTER,Receita com serviços,Outras,../data/raw/BANCO INTER-2022.xlsx
2022-10-05,PIX RECEBIDO LUCAS TEIXEIRA DE SOUZA,,100.0,0.0,9862.41,INTER,Receita com serviços,Outras,../data/raw/BANCO INTER-2022.xlsx
2022-10-05,PIX ENVIADO PATRICK - PAGTO DE TERCEIROS,,0.0,980.0,8882.41,INTER,Despesa com pessoal,Salário,../data/raw/BANCO INTER-2022.xlsx
2022-10-05,PIX RECEBIDO FRANCO DE ALMEIDA MENEGAT,,220.0,0.0,9102.41,INTER,Receita com serviços,Outras,../data/raw/BANCO INTER-2022.xlsx
2022-10-06,PIX RECEBIDO KARLA NATHALIA DA SILVA PEREIRA,,30.0,0.0,9132.41,INTER,Receita com serviços,Outras,../data/raw/BANCO INTER-2022.xlsx
2022-10-06,PIX RECEBIDO MARGARETE APARECIDA OLIVEIRA,,205.0,0.0,9337.41,INTER,Receita com serviços,Outras,../data/raw/BANCO INTER-2022.xlsx
2022-10-06,PIX ENVIADO TATYANA CHAVIER - PAGTO DE SALÁRIO,,0.0,1717.31,7620.1,INTER,Despesa com pessoal,Salário,../data/raw/BANCO INTER-2022.xlsx
2022-10-06,PIX ENVIADO LUIZ GUSTAVO DA SILVA - PAGTO DE RESCISÃO ,,0.0,4088.16,3531.94,INTER,Despesa com pessoal,Aviso prévio / Multa rescisória,../data/raw/BANCO INTER-2022.xlsx
2022-10-06,PIX ENVIADO CLAUDIO - PAGTO PRO LABORE,,0.0,1078.68,2453.26,INTER,Despesa com pessoal,Pró labore,../data/raw/BANCO INTER-2022.xlsx
2022-10-07,COMPRA CARTÃO MATERIAL CONSTRUÇÃO VILA IZABEL,,0.0,11.5,2441.76,INTER,Despesas administrativas,Manutenção predial,../data/raw/BANCO INTER-2022.xlsx
2022-10-07,PIX RECEBIDO TALITA CRISTIANI GABINI DOS SANTOS,,270.0,0.0,2711.76,INTER,Receita com serviços,Outras,../data/raw/BANCO INTER-2022.xlsx
2022-10-10,PIX RECEBIDO EDUARDA MARIANO RECH,,40.0,0.0,2751.76,INTER,Receita com serviços,Outras,../data/raw/BANCO INTER-2022.xlsx
2022-10-10,PIX RECEBIDO CRISLAINE BRAGA DE OLIVEIRA,,140.0,0.0,2891.76,INTER,Receita com serviços,Outras,../data/raw/BANCO INTER-2022.xlsx
2022-10-10,PIX ENVIADO SPRINGER CARRIER - REF. NF 114815,,0.0,131.01,2760.75,INTER,Despesa com serviços,Outras,../data/raw/BANCO INTER-2022.xlsx
2022-10-11,PIX RECEBIDO MARCOS SERENA,,340.0,0.0,3100.75,INTER,Receita com serviços,Outras,../data/raw/BANCO INTER-2022.xlsx
2022-10-13,PIX RECEBIDO CARMEN HELENA GUERRA COLOMBO,,240.0,0.0,3340.75,INTER,Receita com serviços,Outras,../data/raw/BANCO INTER-2022.xlsx
2022-10-14,PIX RECEBIDO SEIKO REFRIGERAÇÃO LTDA,,140.0,0.0,3480.75,INTER,Receita com serviços,Outras,../data/raw/BANCO INTER-2022.xlsx
2022-10-14,COMPRA CARTÃO AUTOPECAS ALVORADA ,,0.0,5.8,3474.95,INTER,Despesa com produtos,Outras,../data/raw/BANCO INTER-2022.xlsx
2022-10-14,PIX RECEBIDO MILENE BATISTA MACIEL,,212.0,0.0,3686.95,INTER,Receita com serviços,Outras,../data/raw/BANCO INTER-2022.xlsx
2022-10-17,PIX RECEBIDO ANTONIO MARIO PIFFER,,80.0,0.0,3766.95,INTER,Receita com serviços,Outras,../data/raw/BANCO INTER-2022.xlsx
2022-10-17,PIX RECEBIDO ASSOCIACAO EC REDENTOR,,390.0,0.0,4156.65,INTER,Receita com serviços,Outras,../data/raw/BANCO INTER-2022.xlsx
2022-10-17,PIX RECEBIDO EXCELENCIA ASSISTÊNCIA TÉCNICA,,109.0,0.0,4265.95,INTER,Receita com serviços,Outras,../data/raw/BANCO INTER-2022.xlsx
2022-10-17,PIX ENVIADO - DEVOLUÇÃO DE VALOR PAGO A MAIS PELA EXCELENCIA ASSISTÊNCIA TÉCNICA,,0.0,74.0,4191.95,INTER,Transferência (Débito),Transferência / Reembolso,../data/raw/BANCO INTER-2022.xlsx
2022-10-17,PIX RECEBIDO AIRTON PAULO GONÇALVES,,45.0,0.0,4236.95,INTER,Receita com serviços,Outras,../data/raw/BANCO INTER-2022.xlsx
2022-10-19,PIX RECEBIDO ROBSON FERNANDES - COMPRA FRITADEIRA E OVENFRYER 1 DE 3 PARC.,,106.92,0.0,4343.87,INTER,Receita de vendas,Outras vendas,../data/raw/BANCO INTER-2022.xlsx
2022-10-19,PIX RECEBIDO ADAILDO LEITE VIEIRA JUNIOR,,280.0,0.0,4623.87,INTER,Receita com serviços,Outras,../data/raw/BANCO INTER-2022.xlsx
2022-10-20,PIX RECEBIDO TATYANA TAMYRES DA SILVA - COMPRA PANELA 1 DE 3 PARCELAS,,88.0,0.0,4711.87,INTER,Receita de vendas,Outras vendas,../data/raw/BANCO INTER-2022.xlsx
2022-10-20,PIX RECEBIDO ELAINE ALINE RIBEIRO,,310.0,0.0,5021.87,INTER,Receita com serviços,Outras,../data/raw/BANCO INTER-2022.xlsx
2022-10-21,PIX RECEBIDO DANIELLE VIEIRA GATTO,,120.0,0.0,5141.87,INTER,Receita com serviços,Outras,../data/raw/BANCO INTER-2022.xlsx
2022-10-21,PIX RECEBIDO DANIELLE VIEIRA GATTO,,120.0,0.0,5261.87,INTER,Receita com serviços,Outras,../data/raw/BANCO INTER-2022.xlsx
2022-10-24,CARTÃO DE CRÉDITO DE CASHBACK,,7.6,0.0,5269.47,INTER,Receita com serviços,Outras,../data/raw/BANCO INTER-2022.xlsx
2022-10-24,PIX RECEBIDO ROSILEIDE DE SOUZA TOGINHO,,50.0,0.0,5319.47,INTER,Receita com serviços,Outras,../data/raw/BANCO INTER-2022.xlsx
2022-10-24,PIX RECEBIDO ANTONIO CARLOS DE ARAUJO COSTA,,390.0,0.0,5709.47,INTER,Receita com serviços,Outras,../data/raw/BANCO INTER-2022.xlsx
2022-10-25,PIX RECEBIDO PEDRO ALVES DA SILVA,,65.0,0.0,5774.47,INTER,Receita com serviços,Outras,../data/raw/BANCO INTER-2022.xlsx
2022-10-25,PIX RECEBIDO CARMEN HELENA GUERRA COLOMBO,,240.0,0.0,6014.47,INTER,Receita com serviços,Outras,../data/raw/BANCO INTER-2022.xlsx
2022-10-27,PIX RECEBIDO GIANCARLO VENCATO,,500.0,0.0,6514.47,INTER,Receita com serviços,Outras,../data/raw/BANCO INTER-2022.xlsx
2022-11-01,PIX RECEBIDO MARIO LUIZ BERNERT,,310.0,0.0,6824.47,INTER,Receita com serviços,Outras,../data/raw/BANCO INTER-2022.xlsx
2022-11-01,PIX RECEBIDO MILENA CONTE CARDOSO,,180.0,0.0,7004.47,INTER,Receita com serviços,Outras,../data/raw/BANCO INTER-2022.xlsx
2022-11-01,PIX RECEBIDO TEREZA ALVES DE FRANCA,,120.0,0.0,7124.47,INTER,Receita com serviços,Outras,../data/raw/BANCO INTER-2022.xlsx
2022-11-01,PIX RECEBIDO WILLIAN NELSON RIBEIRO COELHO,,185.0,0.0,7309.47,INTER,Receita com serviços,Outras,../data/raw/BANCO INTER-2022.xlsx
2022-11-01,PIX ENVIADO PATRICK - PAGTO DE TERCEIROS,,0.0,260.0,7049.47,INTER,Despesa com pessoal,Salário,../data/raw/BANCO INTER-2022.xlsx
2022-11-03,PIX RECEBIDO DEBORA DE FREITAS BARCELOS,,220.0,0.0,7269.47,INTER,Receita com serviços,Outras,../data/raw/BANCO INTER-2022.xlsx
2022-11-03,PIX RECEBIDO ALISSON BATISTA RABELO,,80.0,0.0,7349.47,INTER,Receita com serviços,Outras,../data/raw/BANCO INTER-2022.xlsx
2022-11-03,PIX RECEBIDO GISELLE WINTER AMARAL,,180.0,0.0,7529.47,INTER,Receita com serviços,Outras,../data/raw/BANCO INTER-2022.xlsx
2022-11-04,PIX RECEBIDO ISRAEL DE MACEDO VIANNA,,185.0,0.0,7714.47,INTER,Receita com serviços,Outras,../data/raw/BANCO INTER-2022.xlsx
2022-11-04,COMPRA CARTÃO REDE GERAL FIXADORES E FERRAGE,,0.0,53.0,7661.47,INTER,Despesa com produtos,Outras,../data/raw/BANCO INTER-2022.xlsx
2022-11-07,PIX ENVIADO LAURA - PAGTO DE SALÁRIO,,0.0,1068.8,6592.67,INTER,Despesa com pessoal,Salário,../data/raw/BANCO INTER-2022.xlsx
2022-11-08,PIX RECEBIDO ANA CAROLINA APARECIDA DE PAULA LOPES,,350.0,0.0,6942.67,INTER,Receita com serviços,Outras,../data/raw/BANCO INTER-2022.xlsx
2022-11-08,PIX ENVIADO ASSOCIAÇÃO METROCARD-FAZENDA RIO GRANDE - VT MARINA,,0.0,105.5,6837.17,INTER,Despesa com pessoal,Transporte (VT),../data/raw/BANCO INTER-2022.xlsx
2022-11-08,COMPRA CARTÃO ESTABELECIMENTO MILIUM LJ CURITIBA,,0.0,54.4,6782.77,INTER,Despesa com produtos,Outras,../data/raw/BANCO INTER-2022.xlsx
2022-11-09,PIX RECEBIDO EXCELENCIA ASSISTÊNCIA TÉCNICA,,35.0,0.0,6817.77,INTER,Receita com serviços,Outras,../data/raw/BANCO INTER-2022.xlsx
2022-11-09,PIX RECEBIDO ADOLFO FERNANDO SCHNEIDER,,70.0,0.0,6887.77,INTER,Receita com serviços,Outras,../data/raw/BANCO INTER-2022.xlsx
2022-11-09,PIX RECEBIDO THAYS DENTI FLORES,,220.0,0.0,7107.77,INTER,Receita com serviços,Outras,../data/raw/BANCO INTER-2022.xlsx
2022-11-09,PIX RECEBIDO FERNANDO MANOEL FAUSTINO DA CONCEIÇÃO,,470.0,0.0,7577.77,INTER,Receita com serviços,Outras,../data/raw/BANCO INTER-2022.xlsx
2022-11-10,PIX RECEBIDO JANAINA SAMPAIO MARQUES,,40.0,0.0,7617.77,INTER,Receita com serviços,Outras,../data/raw/BANCO INTER-2022.xlsx
2022-11-11,COMPRA CARTÃO - GIRELLI COMERCIO DE PE CURITIBA,,0.0,62.12,7555.65,INTER,Despesa com produtos,Outras,../data/raw/BANCO INTER-2022.xlsx
2022-11-11,COMPRA CARTÃO - CONFEITARIA FRANCESCH COLOMBO,,0.0,67.8,7487.85,INTER,Despesa com pessoal,Alimentação (VR VA),../data/raw/BANCO INTER-2022.xlsx
2022-11-11,PIX RECEBIDO CONDOMINIO DOM RODRIGO FLAT SERVICE,,295.0,0.0,7782.85,INTER,Receita com serviços,Outras,../data/raw/BANCO INTER-2022.xlsx
2022-11-14,PIX RECEBIDO SAMANTA SABRINA SIZINANDO,,200.0,0.0,7982.85,INTER,Receita com serviços,Outras,../data/raw/BANCO INTER-2022.xlsx
2022-11-14,PIX RECEBIDO SOLANGE KULKAMP VARGAS,,80.0,0.0,8062.85,INTER,Receita com serviços,Outras,../data/raw/BANCO INTER-2022.xlsx
2022-11-14,PIX RECEBIDO MORGANA MUGNOL,,170.0,0.0,8232.85,INTER,Receita com serviços,Outras,../data/raw/BANCO INTER-2022.xlsx
2022-11-21,PIX RECEBIDO LUIZ CARLOS MARIANO,,22.5,0.0,8255.35,INTER,Receita com serviços,Outras,../data/raw/BANCO INTER-2022.xlsx
2022-11-21,PIX RECEBIDO TATYANA TAMYRES DA SILVA - COMPRA PANELA 2 DE 3 PARCELAS,,88.0,0.0,8343.35,INTER,Receita de vendas,Outras vendas,../data/raw/BANCO INTER-2022.xlsx
2022-11-22,PIX RECEBIDO CAMILA COFERI CORREA,,280.0,0.0,8623.35,INTER,Receita com serviços,Outras,../data/raw/BANCO INTER-2022.xlsx
2022-11-22,PIX ENVIADO PROXYS C ELETRONICO LTDA-COMPRA TELA P/ NTB ACER,,0.0,305.38,8317.97,INTER,Despesa com produtos,Outras,../data/raw/BANCO INTER-2022.xlsx
2022-11-22,CASHBACK CARTAO DE CREDITO,,7.68,0.0,8325.65,INTER,Receitas financeiras,Outras,../data/raw/BANCO INTER-2022.xlsx
2022-11-23,COMPRA CARTÃO ESTABELECIMENO RONALDO - 2 CARIMBOS,,0.0,90.0,8235.65,INTER,Despesas administrativas,Outras,../data/raw/BANCO INTER-2022.xlsx
2022-11-24,COMPRA CARTÃO MERCADO ZAMPROGNA - ECEEL,,0.0,63.2,8172.45,INTER,Despesa com produtos,Outras,../data/raw/BANCO INTER-2022.xlsx
2022-11-24,PIX RECEBIDO JUAN RODRIGUES CAVALCANTE,,220.0,0.0,8392.45,INTER,Receita com serviços,Outras,../data/raw/BANCO INTER-2022.xlsx
2022-11-25,PIX RECEBIDO ROBSON FERNANDES,,106.93,0.0,8499.38,INTER,Receita com serviços,Outras,../data/raw/BANCO INTER-2022.xlsx
2022-11-25,PIX RECEBIDO WILLIAN LIRA DE SOUZA,,1050.0,0.0,9549.38,INTER,Receita com serviços,Outras,../data/raw/BANCO INTER-2022.xlsx
2022-11-28,COMPRA CARTÃO HERDEIROSDAPIZZA - ATENDIMENTO ON-SITE PANASONIC,,0.0,61.9,9487.48,INTER,Despesa com produtos,Outras,../data/raw/BANCO INTER-2022.xlsx
2022-11-28,PIX RECEBIDO ROSEMARIA IOGOLIA BIONDO,,200.0,0.0,9687.48,INTER,Receita com serviços,Outras,../data/raw/BANCO INTER-2022.xlsx
2022-11-29,PIX ENVIADO ASSOCIAÇÃO METROCARD,,0.0,83.5,9603.98,INTER,Despesa com pessoal,Transporte (VT),../data/raw/BANCO INTER-2022.xlsx
2022-11-30,PIX RECEBIDO ROSEMARIA IOGOLIA BIONDO,,32.0,0.0,9635.98,INTER,Receita com serviços,Outras,../data/raw/BANCO INTER-2022.xlsx
2022-12-05,PIX ENVIADO ALLISSON - COMPRA DE CADEIRAS ESCRITÓRIOS ECEEL,,0.0,1350.0,8285.98,INTER,Despesas administrativas,Material de escritório,../data/raw/BANCO INTER-2022.xlsx
2022-12-05,COMPRA CARTÃO SUPER PRO BETTEGA,,0.0,29.84,8256.14,INTER,Despesa com produtos,Outras,../data/raw/BANCO INTER-2022.xlsx
2022-12-05,PIX RECEBIDO SHAULA ZUCCHI,,310.0,0.0,8566.14,INTER,Receita com serviços,Outras,../data/raw/BANCO INTER-2022.xlsx
2022-12-05,PIX RECEBIDO VILLAGGIO TRIESTE,,185.0,0.0,8751.14,INTER,Receita com serviços,Outras,../data/raw/BANCO INTER-2022.xlsx
2022-12-05,PIX RECEBIDO VILLAGGIO TRIESTE,,310.0,0.0,9061.14,INTER,Receita com serviços,Outras,../data/raw/BANCO INTER-2022.xlsx
2022-12-05,PIX RECEBIDO BERNARDINO FERREIRA DA SILVA NETO,,120.0,0.0,9181.14,INTER,Receita com serviços,Outras,../data/raw/BANCO INTER-2022.xlsx
2022-12-06,PIX RECEBIDO LORENA DE FÁTIMA NADOLNY,,260.0,0.0,9441.14,INTER,Receita com serviços,Outras,../data/raw/BANCO INTER-2022.xlsx
2022-12-06,PIX ENVIADO TATYANA CHAVIER - PAGTO DE SALÁRIO,,0.0,1669.74,7771.14,INTER,Despesa com pessoal,Salário,../data/raw/BANCO INTER-2022.xlsx
2022-12-06,PIX ENVIADO THIAGO IANUCH MARIN - PAGTO DE SALÁRIO,,0.0,1519.55,6251.85,INTER,Despesa com pessoal,Salário,../data/raw/BANCO INTER-2022.xlsx
2022-12-06,PIX ENVIADO CLAUDIO VINICIUS GALINDO - PAGTO PRO-LABORE,,0.0,1078.68,5173.17,INTER,Despesa com pessoal,Pró labore,../data/raw/BANCO INTER-2022.xlsx
2022-12-06,PIX RECEBIDO CLAUDIO LUIS FRANCA SCHETTINI,,310.0,0.0,5483.17,INTER,Receita com serviços,Outras,../data/raw/BANCO INTER-2022.xlsx
2022-12-06,PIX RECEBIDO MARCELLO DA SILVA BUDOLLA,,90.0,0.0,5573.17,INTER,Receita com serviços,Outras,../data/raw/BANCO INTER-2022.xlsx
2022-12-07,PIX RECEBIDO LARISSA DA ROSA DOS REIS,,200.0,0.0,5773.17,INTER,Receita com serviços,Outras,../data/raw/BANCO INTER-2022.xlsx
2022-12-07,DEVOLUÇÃO DE PIX PARA LORENA DE FATIMA NADOLNY,,0.0,260.0,5513.17,INTER,Transferência (Débito),Transferência / Reembolso,../data/raw/BANCO INTER-2022.xlsx
2022-12-08,PAGAMENTO CIEE - ESTAGIÁRIOS,,0.0,1820.76,3692.41,INTER,Despesa com pessoal,Salário,../data/raw/BANCO INTER-2022.xlsx
2022-12-08,PIX RECEBIDO ALVARO DIAS DA SILVEIRA JUNIOR,,280.0,0.0,3972.41,INTER,Receita com serviços,Outras,../data/raw/BANCO INTER-2022.xlsx
2022-12-08,PIX RECEBIDO CONDOMINIO DOM RODRIGO FLAT SERVICE,,485.0,0.0,4457.41,INTER,Receita com serviços,Outras,../data/raw/BANCO INTER-2022.xlsx
2022-12-08,PIX RECEBIDO LYDIA CRISTINA DE SOUZA NANTES SANTOS,,280.0,0.0,4737.41,INTER,Receita com serviços,Outras,../data/raw/BANCO INTER-2022.xlsx
2022-12-09,DEPOSITO EM CHEQUE - CONSERTO LAVADORA RAULINO,,375.0,0.0,5112.41,INTER,Receita com serviços,Manutenção s/ Garantia,../data/raw/BANCO INTER-2022.xlsx
2022-12-13,PIX RECEBIDO DOUGLAS BACARO,,80.0,0.0,5192.41,INTER,Receita com serviços,Outras,../data/raw/BANCO INTER-2022.xlsx
2022-12-13,PIX RECEBIDO JOSE MÁRIO SOARES SANTOS,,130.0,0.0,5322.41,INTER,Receita com serviços,Outras,../data/raw/BANCO INTER-2022.xlsx
2022-12-14,PIX ENVIADO DEPARTAMENTO DE TRANSITO DETRAN,,0.0,156.18,5166.23,INTER,Despesas administrativas,Veiculos,../data/raw/BANCO INTER-2022.xlsx
2022-12-14,PIX RECEBIDO JAQUELINE CICILOVIC VELASCO,,280.0,0.0,5446.23,INTER,Receita com serviços,Outras,../data/raw/BANCO INTER-2022.xlsx
2022-12-14,PIX RECEBIDO ASSOCIACAO EVANGELICA CRISTO REDENTOR,,470.0,0.0,5916.23,INTER,Receita com serviços,Outras,../data/raw/BANCO INTER-2022.xlsx
2022-12-15,COMPRA CARTÃO VILA IZABEL MATERIAI CONSTRUÇÃO,,0.0,5.0,5911.23,INTER,Despesas administrativas,Manutenção predial,../data/raw/BANCO INTER-2022.xlsx
2022-12-15,PIX RECEBIDO GUILHERME SILVA NASCIMENTO,,540.0,0.0,6451.23,INTER,Receita com serviços,Outras,../data/raw/BANCO INTER-2022.xlsx
2022-12-15,PAGAMENTO CONTA DE ENERGIA LJ 3,,0.0,89.08,6362.15,INTER,Despesas administrativas,Energia,../data/raw/BANCO INTER-2022.xlsx
2022-12-15,PAGAMENTO CONTA DE ENERGIA LJ 4,,0.0,47.45,6314.7,INTER,Despesas administrativas,Energia,../data/raw/BANCO INTER-2022.xlsx
2022-12-15,PAGAMENTO CONTA DE ENERGIA LJ 6,,0.0,332.99,5981.71,INTER,Despesas administrativas,Energia,../data/raw/BANCO INTER-2022.xlsx
2022-12-15,COMPRA CARTÃO - REGARGA CELULAR ECEEL,,0.0,10.0,5971.71,INTER,Despesas administrativas,"Telefonia (Celular, Fixo, Internet)",../data/raw/BANCO INTER-2022.xlsx
2022-12-15,PIX RECEBIDO GELSON PEREIRA DE LIMA,,80.0,0.0,6051.71,INTER,Receita com serviços,Outras,../data/raw/BANCO INTER-2022.xlsx
2022-12-16,PIX RECEBIDO CONDOMINIO DOM RODRIGO FLAT SERVICE,,295.0,0.0,6346.71,INTER,Receita com serviços,Outras,../data/raw/BANCO INTER-2022.xlsx
2022-12-17,PIX RECEBIDO ANDRE LUÍS DE MORAES,,180.0,0.0,6526.71,INTER,Receita com serviços,Outras,../data/raw/BANCO INTER-2022.xlsx
2022-12-17,PIX RECEBIDO LUIZ BISETTO,,180.0,0.0,6706.71,INTER,Receita com serviços,Outras,../data/raw/BANCO INTER-2022.xlsx
2022-12-18,PIX RECEBIDO MARINA CORREA MARTINS,,220.0,0.0,6926.71,INTER,Receita com serviços,Outras,../data/raw/BANCO INTER-2022.xlsx
2022-12-18,PIX RECEBIDO RAFAELE MARIA DO VALLE DE SOUZA,,80.0,0.0,7006.71,INTER,Receita com serviços,Outras,../data/raw/BANCO INTER-2022.xlsx
2022-12-19,PIX RECEBIDO MARCEL DE GASPERI DECOL,,220.0,0.0,7226.71,INTER,Receita com serviços,Outras,../data/raw/BANCO INTER-2022.xlsx
2022-12-19,PIX ENVIADO TATYANA CHAVIER - PAGTO 13º SALÁRIO PARC. FINAL,,0.0,853.75,6372.96,INTER,Despesa com pessoal,13º salário,../data/raw/BANCO INTER-2022.xlsx
2022-12-19,PIX ENVIADO TATYANA CHAVIER - PAGTO FÉRIAS COLETIVA,,0.0,895.35,5477.61,INTER,Despesa com pessoal,Salário,../data/raw/BANCO INTER-2022.xlsx
2022-12-19,PAGAMENTO JUNTA COMERCIAL,,0.0,39.6,5438.01,INTER,Despesas administrativas,Outras,../data/raw/BANCO INTER-2022.xlsx
2022-12-19,PAGAMENTO FATURA CARTÃO INTER,,0.0,2396.16,3041.85,INTER,Despesas administrativas,Outras,../data/raw/BANCO INTER-2022.xlsx
2022-12-20,CASHBACK CARTÃO DE CRÉDITO,,5.99,0.0,3047.84,INTER,Receitas financeiras,Outras,../data/raw/BANCO INTER-2022.xlsx
2022-12-20,COMPRA CARTÃO - SÓ TUDO COMP ELETRONIC,,0.0,26.0,3021.84,INTER,Despesa com produtos,Outras,../data/raw/BANCO INTER-2022.xlsx
2022-12-20,PIX RECEBIDO LUAN - COMPRA FRITADEIRA,,191.3,0.0,3213.14,INTER,Receita de vendas,Outras vendas,../data/raw/BANCO INTER-2022.xlsx
2022-12-20,PIX ENVIADO MINISTERIO DA ECONOMIA - DARF/GPS,,0.0,1348.05,1865.09,INTER,Despesas tributárias ,Outras,../data/raw/BANCO INTER-2022.xlsx
2022-12-20,PIX ENVIADO MINISTERIO DA ECONOMIA - DARF/GPS 13º SALÁRIO,,479.43,0.0,1385.66,INTER,Receita com serviços,Outras,../data/raw/BANCO INTER-2022.xlsx
2022-12-20,PIX ENVIADO MINISTERIO DA ECONOMIA - DARF-IRRF REF ALUGUEL IMÓVEL,,0.0,84.58,1301.08,INTER,Despesas tributárias ,Outras,../data/raw/BANCO INTER-2022.xlsx
2022-12-20,PIX RECEBIDO TATYANA TAMYRES DA SILVA - COMPRA PANELA 3 DE 3 PARCELAS,,88.0,0.0,1389.08,INTER,Receita de vendas,Outras vendas,../data/raw/BANCO INTER-2022.xlsx
2022-12-20,PIX ENVIADO PANIFICADORA BASE DO PAO LTDA - PANETONES FUCIONÁRIOS,,0.0,100.0,1289.08,INTER,Despesa com pessoal,Outras,../data/raw/BANCO INTER-2022.xlsx
2022-12-21,COMPRA CARTÃO PAG*CHECKBOX CURITIBA,,0.0,120.0,1169.08,INTER,Despesa com produtos,Outras,../data/raw/BANCO INTER-2022.xlsx
2022-12-21,PIX RECEBIDO COLORIDO COMÉRCIO DE ALIMENTOS E EMBA,,240.0,0.0,1409.08,INTER,Receita com serviços,Outras,../data/raw/BANCO INTER-2022.xlsx
2022-12-21,COMPRA CARTÃO PANIFICADORA BASE DO PAO LTDA - PANETONES FUNCIONÁRIOS,,0.0,205.0,1204.08,INTER,Despesa com pessoal,Outras,../data/raw/BANCO INTER-2022.xlsx
2022-12-21,RECEBIMENTO DE TÍTULO - CLIENTE MICHELE,,385.0,0.0,1589.08,INTER,Receita com serviços,Outras,../data/raw/BANCO INTER-2022.xlsx
2022-01-04,PG.P/INTERNET - WHITE MARTINS,10002006,0.0,30.9,16284.18,CRED CREA,Despesa com produtos,Materiais de Consumo,../data/raw/BANCO CRED CREA -2022.xlsx
2022-01-04,PG.P/INTERNET - MED CURITIBA,10001995,0.0,100.0,16184.18,CRED CREA,Despesas administrativas,Outras,../data/raw/BANCO CRED CREA -2022.xlsx
2022-01-04,PG.P/INTERNET - SPRINGER CARRIER,10002010,0.0,358.91,15825.27,CRED CREA,Despesa com serviços,Outras,../data/raw/BANCO CRED CREA -2022.xlsx
2022-01-04,CREDITO TED - PAGSEGURO INTERNET LTDA,33834846,846.95,0.0,16672.22,CRED CREA,Despesas administrativas,Seguros,../data/raw/BANCO CRED CREA -2022.xlsx
2022-01-07,PG.P/INTERNET - ALUGUEL,10005388,0.0,3046.25,13625.97,CRED CREA,Despesas administrativas,Aluguel imóvel,../data/raw/BANCO CRED CREA -2022.xlsx
2022-01-10,PREST.EMPREST 034/048,8,0.0,1418.47,12207.5,CRED CREA,Despesas financeiras,Emprestimo,../data/raw/BANCO CRED CREA -2022.xlsx
2022-01-10,DB. ALLIANZ  SEGURO SPIN 6 DE 10,84624000166,0.0,144.05,12063.45,CRED CREA,Despesas administrativas,Seguros,../data/raw/BANCO CRED CREA -2022.xlsx
2022-01-11,CREDITO TED - PAGSEGURO INTERNET LTDA,33655713,1449.7,0.0,13513.15,CRED CREA,Despesas administrativas,Seguros,../data/raw/BANCO CRED CREA -2022.xlsx
2022-01-17,DB. COTAS,19911,0.0,59.5,13453.65,CRED CREA,Despesas financeiras,Despesas bancárias,../data/raw/BANCO CRED CREA -2022.xlsx
2022-01-17,CREDITO TED - PAGSEGURO INTERNET LTDA,16,1517.3,0.0,14970.95,CRED CREA,Despesas administrativas,Seguros,../data/raw/BANCO CRED CREA -2022.xlsx
2022-01-21,CREDITO TED - PAGSEGURO INTERNET LTDA,34071140,696.85,0.0,15667.8,CRED CREA,Despesas administrativas,Seguros,../data/raw/BANCO CRED CREA -2022.xlsx
2022-01-24,CREDITO TED - PAGSEGURO INTERNET LTDA,33887899,807.33,0.0,16475.13,CRED CREA,Despesas administrativas,Seguros,../data/raw/BANCO CRED CREA -2022.xlsx
2022-01-24,PG.P/INTERNET - CARGOBR INTERM E AGENC NEG S A,10004082,0.0,92.52,16382.61,CRED CREA,Despesas administrativas,Outras,../data/raw/BANCO CRED CREA -2022.xlsx
2022-01-25,PG.P/INTERNET - MED CURITIBA,10003015,0.0,100.0,16282.61,CRED CREA,Despesas administrativas,Outras,../data/raw/BANCO CRED CREA -2022.xlsx
2022-01-25,PG.P/INTERNET - Detran taxa licenciamento 2022,10003039,0.0,86.5,16196.11,CRED CREA,Despesas tributárias ,IPVA,../data/raw/BANCO CRED CREA -2022.xlsx
2022-01-25,PG.P/INTERNET - Detran taxa licenciamento 2022,10003169,0.0,86.5,16109.61,CRED CREA,Despesas tributárias ,IPVA,../data/raw/BANCO CRED CREA -2022.xlsx
2022-01-26,CREDITO TED - PAGSEGURO INTERNET LTDA,33979580,264.3,0.0,16373.91,CRED CREA,Despesas administrativas,Seguros,../data/raw/BANCO CRED CREA -2022.xlsx
2022-01-27,CREDITO TED - PAGSEGURO INTERNET LTDA,33991869,1861.8,0.0,18235.71,CRED CREA,Despesas administrativas,Seguros,../data/raw/BANCO CRED CREA -2022.xlsx
2022-01-31,PG.P/INTERNET - VT LUIZ E GUILHERME,10000226,0.0,380.63,17855.08,CRED CREA,Despesa com pessoal,Transporte (VT),../data/raw/BANCO CRED CREA -2022.xlsx
2022-01-31,CREDITO TED - PAGSEGURO INTERNET LTDA,34538571,863.14,0.0,18718.22,CRED CREA,Despesas administrativas,Seguros,../data/raw/BANCO CRED CREA -2022.xlsx
2022-02-02,CREDITO TED - PAGSEGURO INTERNET LTDA,34042829,1666.76,0.0,20384.98,CRED CREA,Despesas administrativas,Seguros,../data/raw/BANCO CRED CREA -2022.xlsx
2022-02-03,CREDITO TED - PAGSEGURO INTERNET LTDA,33928947,1132.17,0.0,21517.15,CRED CREA,Despesas administrativas,Seguros,../data/raw/BANCO CRED CREA -2022.xlsx
2022-02-04,PG.P/INTERNET - DARF - IRRF,10003709,0.0,18.88,21498.27,CRED CREA,Despesa com pessoal,IRPF,../data/raw/BANCO CRED CREA -2022.xlsx
2022-02-04,PG.P/INTERNET - Conta de agua,10007295,0.0,154.06,21344.21,CRED CREA,Despesas administrativas,Água,../data/raw/BANCO CRED CREA -2022.xlsx
2022-02-07,CREDITO TED - PAGSEGURO INTERNET LTDA,33004134,220.89,0.0,21565.1,CRED CREA,Despesas administrativas,Seguros,../data/raw/BANCO CRED CREA -2022.xlsx
2022-02-07,PG.P/INTERNET - WHITE MARTINS,10007653,0.0,30.9,21534.2,CRED CREA,Despesa com produtos,Materiais de Consumo,../data/raw/BANCO CRED CREA -2022.xlsx
2022-02-07,PG.P/INTERNET - ALUGUEL,10007709,0.0,3391.15,18143.05,CRED CREA,Despesas administrativas,Aluguel imóvel,../data/raw/BANCO CRED CREA -2022.xlsx
2022-02-07,PG.P/INTERNET - REFRIGERACAO DUFRIO ,10007787,0.0,376.13,17766.92,CRED CREA,Despesa com serviços,Outras,../data/raw/BANCO CRED CREA -2022.xlsx
2022-02-07,PG.P/INTERNET - SPRINGER CARRIER,10007729,0.0,294.52,17472.4,CRED CREA,Despesa com serviços,Outras,../data/raw/BANCO CRED CREA -2022.xlsx
2022-02-07,PG.P/INTERNET - CIEE - ESTAGIARIO GABRIEL,10007890,0.0,396.36,17076.04,CRED CREA,Despesa com pessoal,Salário,../data/raw/BANCO CRED CREA -2022.xlsx
2022-02-09,PG.P/INTERNET - RED S A - FRESNOMAQ WAP,10003308,0.0,220.26,16855.78,CRED CREA,Despesa com serviços,Outras,../data/raw/BANCO CRED CREA -2022.xlsx
2022-02-09,PG.P/INTERNET - SPRINGER CARRIER,10003419,0.0,105.82,16749.96,CRED CREA,Despesa com serviços,Outras,../data/raw/BANCO CRED CREA -2022.xlsx
2022-02-09,CREDITO TED - PAGSEGURO INTERNET LTDA,33986427,2896.89,0.0,19646.85,CRED CREA,Despesas administrativas,Seguros,../data/raw/BANCO CRED CREA -2022.xlsx
2022-02-10,PREST.EMPREST 035/048,7,0.0,1418.47,18228.38,CRED CREA,Despesas financeiras,Emprestimo,../data/raw/BANCO CRED CREA -2022.xlsx
2022-02-10,DB. ALLIANZ SEGURO SPIN 7 DE 10,84624000166,0.0,144.05,18084.33,CRED CREA,Despesas administrativas,Seguros,../data/raw/BANCO CRED CREA -2022.xlsx
2022-02-15,DB. COTAS,19911,0.0,59.5,18024.83,CRED CREA,Despesas financeiras,Despesas bancárias,../data/raw/BANCO CRED CREA -2022.xlsx
2022-02-15,PG.P/INTERNET CARTÃO INTER,10007750,0.0,2198.74,15826.09,CRED CREA,Despesas administrativas,Outras,../data/raw/BANCO CRED CREA -2022.xlsx
2022-02-18,CREDITO TED - PAGSEGURO INTERNET LTDA,33796704,1526.56,0.0,17352.65,CRED CREA,Despesas administrativas,Seguros,../data/raw/BANCO CRED CREA -2022.xlsx
2022-02-22,CREDITO TED - PAGSEGURO INTERNET LTDA,33005336,881.09,0.0,18233.74,CRED CREA,Despesas administrativas,Seguros,../data/raw/BANCO CRED CREA -2022.xlsx
2022-02-22,PG.P/INTERNET - NET FONE,10002866,0.0,139.88,18093.86,CRED CREA,Despesas administrativas,"Telefonia (Celular, Fixo, Internet)",../data/raw/BANCO CRED CREA -2022.xlsx
2022-02-22,PG.P/INTERNET - COPEL FIBRA,10002877,0.0,149.9,17943.96,CRED CREA,Despesas administrativas,"Telefonia (Celular, Fixo, Internet)",../data/raw/BANCO CRED CREA -2022.xlsx
2022-02-22,PG.P/INTERNET - Celular,10002900,0.0,64.98,17878.98,CRED CREA,Despesas administrativas,"Telefonia (Celular, Fixo, Internet)",../data/raw/BANCO CRED CREA -2022.xlsx
2022-02-22,PG.P/INTERNET - Celular,10002908,0.0,54.99,17823.99,CRED CREA,Despesas administrativas,"Telefonia (Celular, Fixo, Internet)",../data/raw/BANCO CRED CREA -2022.xlsx
2022-02-22,PG.P/INTERNET - SPRINGER CARRIER,10002925,0.0,69.25,17754.74,CRED CREA,Despesa com serviços,Outras,../data/raw/BANCO CRED CREA -2022.xlsx
2022-02-24,PG.P/INTERNET - FRESNOMAQ WAP,10001606,0.0,292.81,17461.93,CRED CREA,Despesa com serviços,Outras,../data/raw/BANCO CRED CREA -2022.xlsx
2022-02-25,CREDITO TED - PAGSEGURO INTERNET LTDA,34109324,595.26,0.0,18057.19,CRED CREA,Despesas administrativas,Seguros,../data/raw/BANCO CRED CREA -2022.xlsx
2022-02-25,PG.P/INTERNET - VT LUIZ,10006946,0.0,245.63,17811.56,CRED CREA,Despesa com pessoal,Transporte (VT),../data/raw/BANCO CRED CREA -2022.xlsx
2022-02-25,PG.P/INTERNET - MED CURITIBA,10006956,0.0,283.0,17528.56,CRED CREA,Despesas administrativas,Outras,../data/raw/BANCO CRED CREA -2022.xlsx
2022-03-02,CREDITO TED - PAGSEGURO INTERNET LTDA,33146391,2625.04,0.0,20153.6,CRED CREA,Despesas administrativas,Seguros,../data/raw/BANCO CRED CREA -2022.xlsx
2022-03-02,PG.P/INTERNET - SPRINGER CARRIER,10009925,0.0,26.0,20127.6,CRED CREA,Despesa com serviços,Outras,../data/raw/BANCO CRED CREA -2022.xlsx
2022-03-02,PG.P/INTERNET - SPRINGER CARRIER,10011744,0.0,123.88,20003.72,CRED CREA,Despesa com serviços,Outras,../data/raw/BANCO CRED CREA -2022.xlsx
2022-03-02,PG.P/INTERNET - SPRINGER CARRIER,10011751,0.0,69.3,19934.42,CRED CREA,Despesa com serviços,Outras,../data/raw/BANCO CRED CREA -2022.xlsx
2022-03-02,PG.P/INTERNET - WHITE MARTINS,10011758,0.0,30.9,19903.52,CRED CREA,Despesa com produtos,Materiais de Consumo,../data/raw/BANCO CRED CREA -2022.xlsx
2022-03-04,CREDITO TED - PAGSEGURO INTERNET LTDA,34161234,440.24,0.0,20343.76,CRED CREA,Despesas administrativas,Seguros,../data/raw/BANCO CRED CREA -2022.xlsx
2022-03-07,PG.P/INTERNET - PAGAMENTO ALUGUEL,10011568,0.0,3391.15,16952.61,CRED CREA,Despesas administrativas,Aluguel imóvel,../data/raw/BANCO CRED CREA -2022.xlsx
2022-03-08,PG.P/INTERNET - CIEE - ESTAGIARIO GABRIEL,10001942,0.0,396.36,16556.25,CRED CREA,Despesa com pessoal,Salário,../data/raw/BANCO CRED CREA -2022.xlsx
2022-03-08,PG.P/INTERNET - SPRINGER CARRIER,10001956,0.0,294.51,16261.74,CRED CREA,Despesa com serviços,Outras,../data/raw/BANCO CRED CREA -2022.xlsx
2022-03-08,CREDITO TED - PAGSEGURO INTERNET LTDA,34191935,468.13,0.0,16729.87,CRED CREA,Despesas administrativas,Seguros,../data/raw/BANCO CRED CREA -2022.xlsx
2022-03-09,CREDITO TED - PICPAY SERVICOS S A,33693223,528.7,0.0,17258.57,CRED CREA,Receita com serviços,Outras,../data/raw/BANCO CRED CREA -2022.xlsx
2022-03-10,PREST.EMPREST 036/048,7,0.0,1418.47,15840.1,CRED CREA,Despesas financeiras,Emprestimo,../data/raw/BANCO CRED CREA -2022.xlsx
2022-03-10,DB. ALLIANZ SEGURO SPIN 8 DE 10,84624000166,0.0,144.05,15696.05,CRED CREA,Despesas administrativas,Seguros,../data/raw/BANCO CRED CREA -2022.xlsx
2022-03-14,CR.APL.RDCPOS,153,1500.0,0.0,17196.05,CRED CREA,Receitas financeiras,Rendimento Aplicações,../data/raw/BANCO CRED CREA -2022.xlsx
2022-03-14,DEBITO PIX - LEONARDO - COMPRA MOTO,78299960,0.0,16000.0,1196.05,CRED CREA,Despesas administrativas,Veiculos,../data/raw/BANCO CRED CREA -2022.xlsx
2022-03-14,PIX TRANSF PAGADOR,78299960,0.0,4.99,1191.06,CRED CREA,Transferência (Débito),Outras,../data/raw/BANCO CRED CREA -2022.xlsx
2022-03-15,DB. COTAS,19911,0.0,59.5,1131.56,CRED CREA,Despesas financeiras,Despesas bancárias,../data/raw/BANCO CRED CREA -2022.xlsx
2022-03-16,CREDITO TED - PAGSEGURO INTERNET LTDA,34156294,192.22,0.0,1323.78,CRED CREA,Despesas administrativas,Seguros,../data/raw/BANCO CRED CREA -2022.xlsx
2022-03-23,PG.P/INTERNET - SPRINGER CARRIER,10000867,0.0,266.95,1056.83,CRED CREA,Despesa com serviços,Outras,../data/raw/BANCO CRED CREA -2022.xlsx
2022-03-23,PG.P/INTERNET - COPEL FIBRA,10000905,0.0,149.9,906.93,CRED CREA,Despesas administrativas,"Telefonia (Celular, Fixo, Internet)",../data/raw/BANCO CRED CREA -2022.xlsx
2022-03-23,PG.P/INTERNET - FRESNOMAQ WAP,10000881,0.0,218.94,687.99,CRED CREA,Despesa com serviços,Outras,../data/raw/BANCO CRED CREA -2022.xlsx
2022-03-23,PG.P/INTERNET - NET FONE,10000893,0.0,148.21,539.78,CRED CREA,Despesas administrativas,"Telefonia (Celular, Fixo, Internet)",../data/raw/BANCO CRED CREA -2022.xlsx
2022-03-23,PG.P/INTERNET - celular,10000914,0.0,64.98,474.8,CRED CREA,Despesas administrativas,"Telefonia (Celular, Fixo, Internet)",../data/raw/BANCO CRED CREA -2022.xlsx
2022-03-23,PG.P/INTERNET - SPRINGER CARRIER,10000949,0.0,183.61,291.19,CRED CREA,Despesa com serviços,Outras,../data/raw/BANCO CRED CREA -2022.xlsx
2022-03-23,PG.P/INTERNET - SPRINGER CARRIER,10000938,0.0,69.24,221.95,CRED CREA,Despesa com serviços,Outras,../data/raw/BANCO CRED CREA -2022.xlsx
2022-03-23,CREDITO PIX - HDI SEGUROS S A - REEMBOLSO MOTO-NF-e 3674,81010391,8841.87,0.0,9063.82,CRED CREA,Despesas administrativas,Seguros,../data/raw/BANCO CRED CREA -2022.xlsx
2022-03-24,PG.P/INTERNET - celular,10001060,0.0,54.99,9008.83,CRED CREA,Despesas administrativas,"Telefonia (Celular, Fixo, Internet)",../data/raw/BANCO CRED CREA -2022.xlsx
2022-03-28,CREDITO TED - PAGSEGURO INTERNET LTDA,33029925,1983.8,0.0,10992.63,CRED CREA,Despesas administrativas,Seguros,../data/raw/BANCO CRED CREA -2022.xlsx
2022-03-28,CREDITO TED - PICPAY SERVICOS S A,33975373,0.02,0.0,10992.65,CRED CREA,Receita com serviços,Outras,../data/raw/BANCO CRED CREA -2022.xlsx
2022-03-29,PG.P/INTERNET - VALE TRANSPORTE LUIZ,10001180,0.0,255.63,10737.02,CRED CREA,Despesa com pessoal,Transporte (VT),../data/raw/BANCO CRED CREA -2022.xlsx
2022-03-29,PG.P/INTERNET - CONSELHO REGIONAL DOS TECNICOS,10001201,0.0,297.95,10439.07,CRED CREA,Despesa com pessoal,Outras,../data/raw/BANCO CRED CREA -2022.xlsx
2022-03-29,PG.P/INTERNET - MED CURITIBA,10001191,0.0,120.0,10319.07,CRED CREA,Despesas administrativas,Outras,../data/raw/BANCO CRED CREA -2022.xlsx
2022-03-29,PG.P/INTERNET - ENGMEC DISTRIBUICAO,10001210,0.0,290.4,10028.67,CRED CREA,Despesa com serviços,Outras,../data/raw/BANCO CRED CREA -2022.xlsx
2022-03-29,PG.P/INTERNET - TAXA DE CORPO DE BOMBEIROS,10001340,0.0,107.66,9921.01,CRED CREA,Despesas tributárias ,Bombeiros,../data/raw/BANCO CRED CREA -2022.xlsx
2022-03-31,CREDITO TED - PAGSEGURO INTERNET LTDA,34502289,1453.54,0.0,11374.55,CRED CREA,Despesas administrativas,Seguros,../data/raw/BANCO CRED CREA -2022.xlsx
2022-04-01,PG.P/INTERNET - SPRINGER CARRIER,10002157,0.0,335.09,11039.46,CRED CREA,Despesa com serviços,Outras,../data/raw/BANCO CRED CREA -2022.xlsx
2022-04-01,PG.P/INTERNET - Conta de agua,10002202,0.0,159.85,10879.61,CRED CREA,Despesas administrativas,Água,../data/raw/BANCO CRED CREA -2022.xlsx
2022-04-01,PG.P/INTERNET - WHITE MARTINS,10002180,0.0,30.9,10848.71,CRED CREA,Despesa com produtos,Materiais de Consumo,../data/raw/BANCO CRED CREA -2022.xlsx
2022-04-01,PG.P/INTERNET - ENGMEC DISTRIBUICAO,10002228,0.0,290.4,10558.31,CRED CREA,Despesa com serviços,Outras,../data/raw/BANCO CRED CREA -2022.xlsx
2022-04-01,CREDITO TED - PAGSEGURO INTERNET LTDA,33998000,758.68,0.0,11316.99,CRED CREA,Despesas administrativas,Seguros,../data/raw/BANCO CRED CREA -2022.xlsx
2022-04-07,CREDITO TED - PAGSEGURO INTERNET LTDA,33810910,1386.33,0.0,12703.32,CRED CREA,Despesas administrativas,Seguros,../data/raw/BANCO CRED CREA -2022.xlsx
2022-04-07,PG.P/INTERNET - CIEE - ESTAGIARIO GABRIEL,10002783,0.0,396.36,12306.96,CRED CREA,Despesa com pessoal,Salário,../data/raw/BANCO CRED CREA -2022.xlsx
2022-04-07,PG.P/INTERNET - PAGAMENTO ALUGUEL,10002838,0.0,3391.15,8915.81,CRED CREA,Despesas administrativas,Aluguel imóvel,../data/raw/BANCO CRED CREA -2022.xlsx
2022-04-07,PG.P/INTERNET - SPRINGER CARRIER,10002859,0.0,89.24,8826.57,CRED CREA,Despesa com serviços,Outras,../data/raw/BANCO CRED CREA -2022.xlsx
2022-04-07,PG.P/INTERNET - PACKPAR EMBALAGENS EIRELI,10002879,0.0,573.86,8252.71,CRED CREA,Despesa com produtos,Materiais de Consumo,../data/raw/BANCO CRED CREA -2022.xlsx
2022-04-08,CREDITO TED - PAGSEGURO INTERNET LTDA,33926648,692.18,0.0,8944.89,CRED CREA,Despesas administrativas,Seguros,../data/raw/BANCO CRED CREA -2022.xlsx
2022-04-11,PREST.EMPREST 037/048,5,0.0,1418.47,7526.42,CRED CREA,Despesas financeiras,Emprestimo,../data/raw/BANCO CRED CREA -2022.xlsx
2022-04-11,DB. ALLIANZ SEGURO SPIN 9 DE 10,84624000166,0.0,144.05,7382.37,CRED CREA,Despesas administrativas,Seguros,../data/raw/BANCO CRED CREA -2022.xlsx
2022-04-12,PG.P/INTERNET - AKROM PRODUTOS ELETRONICOS EIR,10004916,0.0,298.0,7084.37,CRED CREA,Despesas administrativas,Outras,../data/raw/BANCO CRED CREA -2022.xlsx
2022-04-12,PG.P/INTERNET - SPRINGER CARRIER,10004933,0.0,29.46,7054.91,CRED CREA,Despesa com serviços,Outras,../data/raw/BANCO CRED CREA -2022.xlsx
2022-04-12,PG.P/INTERNET - JUNTA COMERCIAL DO PARANA,10004942,0.0,79.2,6975.71,CRED CREA,Despesas financeiras,Outras,../data/raw/BANCO CRED CREA -2022.xlsx
2022-04-12,PG.P/INTERNET - CIEE RESCISAO ESTAG GABRIEL,10004967,0.0,139.7,6836.01,CRED CREA,Despesa com pessoal,Aviso prévio / Multa rescisória,../data/raw/BANCO CRED CREA -2022.xlsx
2022-04-13,CREDITO TED - PAGSEGURO INTERNET LTDA,33037149,1154.29,0.0,7990.3,CRED CREA,Despesas administrativas,Seguros,../data/raw/BANCO CRED CREA -2022.xlsx
2022-04-18,DB. COTAS,19911,0.0,59.5,7930.8,CRED CREA,Despesas financeiras,Despesas bancárias,../data/raw/BANCO CRED CREA -2022.xlsx
2022-04-19,CREDITO TED - PAGSEGURO INTERNET LTDA,34113572,2187.24,0.0,10118.04,CRED CREA,Despesas administrativas,Seguros,../data/raw/BANCO CRED CREA -2022.xlsx
2022-04-19,PG.P/INTERNET - DAS,10003609,0.0,1964.17,8153.87,CRED CREA,Despesas tributárias ,Outras,../data/raw/BANCO CRED CREA -2022.xlsx
2022-04-19,PG.P/INTERNET - SPRINGER CARRIER,10003691,0.0,266.94,7886.93,CRED CREA,Despesa com serviços,Outras,../data/raw/BANCO CRED CREA -2022.xlsx
2022-04-19,PG.P/INTERNET - PACKPAR EMBALAGENS EIRELI,10003712,0.0,573.86,7313.07,CRED CREA,Despesa com produtos,Materiais de Consumo,../data/raw/BANCO CRED CREA -2022.xlsx
2022-04-22,DB. ALLIANZ SEGURO MOTO 1 DE 10,84624000166,0.0,157.91,7155.16,CRED CREA,Despesas administrativas,Seguros,../data/raw/BANCO CRED CREA -2022.xlsx
2022-04-25,CREDITO TED - PAGSEGURO INTERNET LTDA,34540675,1160.7,0.0,8315.86,CRED CREA,Despesas administrativas,Seguros,../data/raw/BANCO CRED CREA -2022.xlsx
2022-04-29,CREDITO TED - PAGSEGURO INTERNET LTDA,34283915,768.88,0.0,9084.74,CRED CREA,Despesas administrativas,Seguros,../data/raw/BANCO CRED CREA -2022.xlsx
2022-05-03,CREDITO TED - PAGSEGURO INTERNET LTDA,34112145,400.98,0.0,9485.72,CRED CREA,Despesas administrativas,Seguros,../data/raw/BANCO CRED CREA -2022.xlsx
2022-05-05,CREDITO TED - PAGSEGURO INTERNET LTDA,33517037,337.14,0.0,9822.86,CRED CREA,Despesas administrativas,Seguros,../data/raw/BANCO CRED CREA -2022.xlsx
2022-05-09,CREDITO TED - PAGSEGURO INTERNET LTDA,34694196,654.94,0.0,10477.8,CRED CREA,Despesas administrativas,Seguros,../data/raw/BANCO CRED CREA -2022.xlsx
2022-05-10,PREST.EMPREST 038/048,4,0.0,1418.47,9059.33,CRED CREA,Despesas financeiras,Emprestimo,../data/raw/BANCO CRED CREA -2022.xlsx
2022-05-10,DB. ALLIANZ SEGURO SPIN 10 DE 10,84624000166,0.0,144.12,8915.21,CRED CREA,Despesas administrativas,Seguros,../data/raw/BANCO CRED CREA -2022.xlsx
2022-05-10,CREDITO TED - PICPAY,33690555,504.05,0.0,9419.26,CRED CREA,Receita com serviços,Outras,../data/raw/BANCO CRED CREA -2022.xlsx
2022-05-11,CREDITO TED - PAGSEGURO INTERNET LTDA,34249720,403.66,0.0,9822.92,CRED CREA,Despesas administrativas,Seguros,../data/raw/BANCO CRED CREA -2022.xlsx
2022-05-12,CREDITO TED - PAGSEGURO INTERNET LTDA,33727837,481.81,0.0,10304.73,CRED CREA,Despesas administrativas,Seguros,../data/raw/BANCO CRED CREA -2022.xlsx
2022-05-16,DB. COTAS,19911,0.0,59.5,10245.23,CRED CREA,Despesas financeiras,Despesas bancárias,../data/raw/BANCO CRED CREA -2022.xlsx
2022-05-17,CREDITO TED - PAGSEGURO INTERNET LTDA,33794913,1043.81,0.0,11289.04,CRED CREA,Despesas administrativas,Seguros,../data/raw/BANCO CRED CREA -2022.xlsx
2022-05-20,DB. ALLIANZ SEGURO MOTO 2 DE 10,84624000166,0.0,157.91,11131.13,CRED CREA,Despesas administrativas,Seguros,../data/raw/BANCO CRED CREA -2022.xlsx
2022-05-23,CREDITO TED - PAGSEGURO INTERNET LTDA,33039610,1789.34,0.0,12920.47,CRED CREA,Despesas administrativas,Seguros,../data/raw/BANCO CRED CREA -2022.xlsx
2022-05-27,CREDITO TED - PAGSEGURO INTERNET LTDA,33741404,622.63,0.0,13543.1,CRED CREA,Despesas administrativas,Seguros,../data/raw/BANCO CRED CREA -2022.xlsx
2022-05-31,CREDITO TED - PAGSEGURO INTERNET LTDA,34607196,1124.41,0.0,14667.51,CRED CREA,Despesas administrativas,Seguros,../data/raw/BANCO CRED CREA -2022.xlsx
2022-06-01,CREDITO TED - PAGSEGURO INTERNET LTDA,34391674,1196.09,0.0,15863.6,CRED CREA,Despesas administrativas,Seguros,../data/raw/BANCO CRED CREA -2022.xlsx
2022-06-03,CREDITO TED - PAGSEGURO INTERNET LTDA,33871162,1394.24,0.0,17257.84,CRED CREA,Despesas administrativas,Seguros,../data/raw/BANCO CRED CREA -2022.xlsx
2022-06-06,CREDITO TED - PAGSEGURO INTERNET LTDA,33834753,1371.58,0.0,18629.42,CRED CREA,Despesas administrativas,Seguros,../data/raw/BANCO CRED CREA -2022.xlsx
2022-06-10,PREST.EMPREST 039/048,4,0.0,1418.47,17210.95,CRED CREA,Despesas financeiras,Emprestimo,../data/raw/BANCO CRED CREA -2022.xlsx
2022-06-10,CREDITO TED - PAGSEGURO INTERNET LTDA,34062533,623.77,0.0,17834.72,CRED CREA,Despesas administrativas,Seguros,../data/raw/BANCO CRED CREA -2022.xlsx
2022-06-13,CREDITO TED - PICPAY,33816104,633.67,0.0,18468.39,CRED CREA,Receita com serviços,Outras,../data/raw/BANCO CRED CREA -2022.xlsx
2022-06-13,CREDITO TED - PAGSEGURO INTERNET LTDA,33862292,781.42,0.0,19249.81,CRED CREA,Despesas administrativas,Seguros,../data/raw/BANCO CRED CREA -2022.xlsx
2022-06-15,DB. COTAS,19911,0.0,59.5,19190.31,CRED CREA,Despesas financeiras,Despesas bancárias,../data/raw/BANCO CRED CREA -2022.xlsx
2022-06-15,CREDITO TED - PAGSEGURO INTERNET LTDA,33849917,978.44,0.0,20168.75,CRED CREA,Despesas administrativas,Seguros,../data/raw/BANCO CRED CREA -2022.xlsx
2022-06-17,PG.P/INTERNET - SOLUCAO CERTIFICACAO DIGITAL L,10005060,0.0,175.0,19993.75,CRED CREA,Despesas administrativas,Outras,../data/raw/BANCO CRED CREA -2022.xlsx
2022-06-17,PG.P/INTERNET - SPRINGER CARRIER,10005084,0.0,49.74,19944.01,CRED CREA,Despesa com serviços,Outras,../data/raw/BANCO CRED CREA -2022.xlsx
2022-06-20,DB. ALLIANZ SEGURO MOTO 3 DE 10,84624000166,0.0,157.91,19786.1,CRED CREA,Despesas administrativas,Seguros,../data/raw/BANCO CRED CREA -2022.xlsx
2022-06-20,CREDITO TED - PAGSEGURO INTERNET LTDA,34278316,489.6,0.0,20275.7,CRED CREA,Despesas administrativas,Seguros,../data/raw/BANCO CRED CREA -2022.xlsx
2022-06-20,PG.P/INTERNET - DAS,10005972,0.0,3013.85,17261.85,CRED CREA,Despesas tributárias ,Outras,../data/raw/BANCO CRED CREA -2022.xlsx
2022-06-20,PG.P/INTERNET - MASTER FILME C EMBALAGENS LTDA,10006015,0.0,426.53,16835.32,CRED CREA,Despesa com produtos,Materiais de Consumo,../data/raw/BANCO CRED CREA -2022.xlsx
2022-06-22,CREDITO TED - PAGSEGURO INTERNET LTDA,34025210,642.23,0.0,17477.55,CRED CREA,Despesas administrativas,Seguros,../data/raw/BANCO CRED CREA -2022.xlsx
2022-06-23,CREDITO TED - PAGSEGURO INTERNET LTDA,33972045,1917.2,0.0,19394.75,CRED CREA,Despesas administrativas,Seguros,../data/raw/BANCO CRED CREA -2022.xlsx
2022-06-23,PG.P/INTERNET - PACKPAR EMBALAGENS EIRELI,10003144,0.0,432.21,18962.54,CRED CREA,Despesa com produtos,Materiais de Consumo,../data/raw/BANCO CRED CREA -2022.xlsx
2022-06-23,PG.P/INTERNET - MASTER FILME C EMBALAGENS LTDA,10003146,0.0,426.53,18536.01,CRED CREA,Despesa com produtos,Materiais de Consumo,../data/raw/BANCO CRED CREA -2022.xlsx
2022-06-24,PG.P/INTERNET - NET FONE,10001110,0.0,139.88,18396.13,CRED CREA,Despesas administrativas,"Telefonia (Celular, Fixo, Internet)",../data/raw/BANCO CRED CREA -2022.xlsx
2022-06-24,PG.P/INTERNET - Celular,10001126,0.0,64.99,18331.14,CRED CREA,Despesas administrativas,"Telefonia (Celular, Fixo, Internet)",../data/raw/BANCO CRED CREA -2022.xlsx
2022-06-24,PG.P/INTERNET - Ligga telecon,10001123,0.0,149.9,18181.24,CRED CREA,Despesas administrativas,"Telefonia (Celular, Fixo, Internet)",../data/raw/BANCO CRED CREA -2022.xlsx
2022-06-24,CREDITO TED - PAGSEGURO INTERNET LTDA,33422247,585.55,0.0,18766.79,CRED CREA,Despesas administrativas,Seguros,../data/raw/BANCO CRED CREA -2022.xlsx
2022-06-24,PG.P/INTERNET - MED CURITIBA,10003245,0.0,156.0,18610.79,CRED CREA,Despesas administrativas,Outras,../data/raw/BANCO CRED CREA -2022.xlsx
2022-06-27,CREDITO TED - PAGSEGURO INTERNET LTDA,34022980,631.07,0.0,19241.86,CRED CREA,Despesas administrativas,Seguros,../data/raw/BANCO CRED CREA -2022.xlsx
2022-06-29,CREDITO TED - PAGSEGURO INTERNET LTDA,33868331,1151.25,0.0,20393.11,CRED CREA,Despesas administrativas,Seguros,../data/raw/BANCO CRED CREA -2022.xlsx
2022-06-30,PG.P/INTERNET - FUNDO DE URBANIZACAO DE CURITI,10004497,0.0,519.63,19873.48,CRED CREA,Despesas administrativas,Outras,../data/raw/BANCO CRED CREA -2022.xlsx
2022-07-01,CREDITO TED - PAGSEGURO INTERNET LTDA,34153379,936.31,0.0,20809.79,CRED CREA,Despesas administrativas,Seguros,../data/raw/BANCO CRED CREA -2022.xlsx
2022-07-05,CREDITO TED - PAGSEGURO INTERNET LTDA,33550405,963.1,0.0,21772.89,CRED CREA,Despesas administrativas,Seguros,../data/raw/BANCO CRED CREA -2022.xlsx
2022-07-05,PG.P/INTERNET - Conta de agua,10003399,0.0,208.42,21564.47,CRED CREA,Despesas administrativas,Água,../data/raw/BANCO CRED CREA -2022.xlsx
2022-07-05,PG.P/INTERNET - MASTER FILME C EMBALAGENS LTDA,10003456,0.0,426.54,21137.93,CRED CREA,Despesa com produtos,Materiais de Consumo,../data/raw/BANCO CRED CREA -2022.xlsx
2022-07-05,PG.P/INTERNET - WHITE MARTINS,10003468,0.0,30.9,21107.03,CRED CREA,Despesa com produtos,Materiais de Consumo,../data/raw/BANCO CRED CREA -2022.xlsx
2022-07-08,PG.P/INTERNET - CIEE - PR,10002638,0.0,712.72,20394.31,CRED CREA,Despesa com pessoal,Salário,../data/raw/BANCO CRED CREA -2022.xlsx
2022-07-08,PG.P/INTERNET - CIEE - PR,10002682,0.0,174.7,20219.61,CRED CREA,Despesa com pessoal,Salário,../data/raw/BANCO CRED CREA -2022.xlsx
2022-07-08,PG.P/INTERNET - PAGAMENTO ALUGUEL,10002717,0.0,4058.09,16161.52,CRED CREA,Despesas administrativas,Aluguel imóvel,../data/raw/BANCO CRED CREA -2022.xlsx
2022-07-08,CREDITO TED - PAGSEGURO INTERNET LTDA,33809671,2444.52,0.0,18606.04,CRED CREA,Despesas administrativas,Seguros,../data/raw/BANCO CRED CREA -2022.xlsx
2022-07-11,PREST.EMPREST 040/048,6,0.0,1418.47,17187.57,CRED CREA,Despesas financeiras,Emprestimo,../data/raw/BANCO CRED CREA -2022.xlsx
2022-07-12,CREDITO TED - PAGSEGURO INTERNET LTDA,33736860,1716.77,0.0,18904.34,CRED CREA,Despesas administrativas,Seguros,../data/raw/BANCO CRED CREA -2022.xlsx
2022-07-13,CREDITO TED - PAGSEGURO INTERNET LTDA,33919679,245.52,0.0,19149.86,CRED CREA,Despesas administrativas,Seguros,../data/raw/BANCO CRED CREA -2022.xlsx
2022-07-14,PG.P/INTERNET - CONTA DE ENERGIA LJ 03,10001694,0.0,143.03,19006.83,CRED CREA,Despesas administrativas,Energia,../data/raw/BANCO CRED CREA -2022.xlsx
2022-07-14,PG.P/INTERNET - CONTA DE ENERGIA LJ 04,10001698,0.0,137.56,18869.27,CRED CREA,Despesas administrativas,Energia,../data/raw/BANCO CRED CREA -2022.xlsx
2022-07-14,PG.P/INTERNET - CONTA DE ENERGIA LJ 06,10001714,0.0,511.2,18358.07,CRED CREA,Despesas administrativas,Energia,../data/raw/BANCO CRED CREA -2022.xlsx
2022-07-14,PG.P/INTERNET - SPRINGER CARRIER,10001718,0.0,166.73,18191.34,CRED CREA,Despesa com serviços,Outras,../data/raw/BANCO CRED CREA -2022.xlsx
2022-07-14,CREDITO TED - PAGSEGURO INTERNET LTDA,33768163,240.0,0.0,18431.34,CRED CREA,Despesas administrativas,Seguros,../data/raw/BANCO CRED CREA -2022.xlsx
2022-07-15,DB. COTAS,19911,0.0,59.5,18371.84,CRED CREA,Despesas financeiras,Despesas bancárias,../data/raw/BANCO CRED CREA -2022.xlsx
2022-07-15,CREDITO TED - PAGSEGURO INTERNET LTDA,34241470,481.23,0.0,18853.07,CRED CREA,Despesas administrativas,Seguros,../data/raw/BANCO CRED CREA -2022.xlsx
2022-07-19,CREDITO TED - PIC PAY,33665038,422.44,0.0,19275.51,CRED CREA,Receita com serviços,Outras,../data/raw/BANCO CRED CREA -2022.xlsx
2022-07-20,DB. ALLIANZ - SEGURO MOTO 4 DE 10,84624000166,0.0,157.91,19117.6,CRED CREA,Despesas administrativas,Seguros,../data/raw/BANCO CRED CREA -2022.xlsx
2022-07-20,CREDITO TED - PAGSEGURO INTERNET LTDA,34050849,2055.28,0.0,21172.88,CRED CREA,Despesas administrativas,Seguros,../data/raw/BANCO CRED CREA -2022.xlsx
2022-07-21,CREDITO TED - PAGSEGURO INTERNET LTDA,33658392,343.45,0.0,21516.33,CRED CREA,Despesas administrativas,Seguros,../data/raw/BANCO CRED CREA -2022.xlsx
2022-07-25,CREDITO TED - PAGSEGURO INTERNET LTDA,34376558,580.68,0.0,22097.01,CRED CREA,Despesas administrativas,Seguros,../data/raw/BANCO CRED CREA -2022.xlsx
2022-07-27,CREDITO TED - PAGSEGURO INTERNET LTDA,33533671,955.51,0.0,23052.52,CRED CREA,Despesas administrativas,Seguros,../data/raw/BANCO CRED CREA -2022.xlsx
2022-08-03,CREDITO TED - PAGSEGURO INTERNET LTDA,33525740,2774.94,0.0,25827.46,CRED CREA,Despesas administrativas,Seguros,../data/raw/BANCO CRED CREA -2022.xlsx
2022-08-08,CREDITO TED - PAGSEGURO INTERNET LTDA,34599314,2687.04,0.0,28514.5,CRED CREA,Despesas administrativas,Seguros,../data/raw/BANCO CRED CREA -2022.xlsx
2022-08-09,CREDITO TED - PAGSEGURO INTERNET LTDA,33644989,1200.83,0.0,29715.33,CRED CREA,Despesas administrativas,Seguros,../data/raw/BANCO CRED CREA -2022.xlsx
2022-08-10,PREST.EMPREST 041/048,6,0.0,1418.47,28296.86,CRED CREA,Despesas financeiras,Emprestimo,../data/raw/BANCO CRED CREA -2022.xlsx
2022-08-12,CREDITO TED - PAGSEGURO INTERNET LTDA,33677214,1712.14,0.0,30009,CRED CREA,Despesas administrativas,Seguros,../data/raw/BANCO CRED CREA -2022.xlsx
2022-08-12,PG.P/INTERNET - CARTAO INTER SA,10004492,0.0,2816.85,27192.15,CRED CREA,Despesas administrativas,Outras,../data/raw/BANCO CRED CREA -2022.xlsx
2022-08-15,DB. ALLIANZ - SEGURO SPIN 1 DE 10,84624000166,0.0,184.78,27007.37,CRED CREA,Despesas administrativas,Seguros,../data/raw/BANCO CRED CREA -2022.xlsx
2022-08-15,DB. COTAS,19911,0.0,66.48,26940.89,CRED CREA,Despesas financeiras,Despesas bancárias,../data/raw/BANCO CRED CREA -2022.xlsx
2022-08-17,CREDITO TED - PAGSEGURO INTERNET LTDA,34137851,3546.39,0.0,30487.28,CRED CREA,Despesas administrativas,Seguros,../data/raw/BANCO CRED CREA -2022.xlsx
2022-08-17,DB.APL.RDCPOS,84000003,0.0,20000.0,10487.28,CRED CREA,Despesas financeiras,Emprestimo,../data/raw/BANCO CRED CREA -2022.xlsx
2022-08-19,CREDITO TED - PIC PAY,33622418,292.83,0.0,10780.11,CRED CREA,Receita com serviços,Outras,../data/raw/BANCO CRED CREA -2022.xlsx
2022-08-22,DB. ALLIANZ - SEGURO MOTO 5 DE 10,84624000166,0.0,157.91,10622.2,CRED CREA,Despesas administrativas,Seguros,../data/raw/BANCO CRED CREA -2022.xlsx
2022-08-22,CREDITO TED - PAGSEGURO INTERNET LTDA,34344606,2404.64,0.0,13026.84,CRED CREA,Despesas administrativas,Seguros,../data/raw/BANCO CRED CREA -2022.xlsx
2022-08-24,CREDITO TED - PAGSEGURO INTERNET LTDA,33966322,1895.51,0.0,14922.35,CRED CREA,Despesas administrativas,Seguros,../data/raw/BANCO CRED CREA -2022.xlsx
2022-08-25,CREDITO TED - PAGSEGURO INTERNET LTDA,34037177,466.1,0.0,15388.45,CRED CREA,Despesas administrativas,Seguros,../data/raw/BANCO CRED CREA -2022.xlsx
2022-08-29,DB.APL.RDCPOS,84000004,0.0,5000.0,10388.45,CRED CREA,Despesas financeiras,Emprestimo,../data/raw/BANCO CRED CREA -2022.xlsx
2022-08-30,CREDITO TED - PAGSEGURO INTERNET LTDA,33693478,2574.57,0.0,12963.02,CRED CREA,Despesas administrativas,Seguros,../data/raw/BANCO CRED CREA -2022.xlsx
2022-09-09,CREDITO TED - PAGSEGURO INTERNET LTDA,33761332,2054.45,0.0,15017.47,CRED CREA,Despesas administrativas,Seguros,../data/raw/BANCO CRED CREA -2022.xlsx
2022-09-12,PREST.EMPREST 042/048,5,0.0,1418.47,13599,CRED CREA,Despesas financeiras,Emprestimo,../data/raw/BANCO CRED CREA -2022.xlsx
2022-09-12,DB. ALLIANZ - SEGURO SPIN 2 DE 10,84624000166,0.0,184.78,13414.22,CRED CREA,Despesas administrativas,Seguros,../data/raw/BANCO CRED CREA -2022.xlsx
2022-09-14,CREDITO TED - PAGSEGURO INTERNET LTDA,33644584,1212.06,0.0,14626.28,CRED CREA,Despesas administrativas,Seguros,../data/raw/BANCO CRED CREA -2022.xlsx
2022-09-14,PG.P/INTERNET - DARF GPS,10002086,0.0,1572.31,13053.97,CRED CREA,Despesa com pessoal,INSS,../data/raw/BANCO CRED CREA -2022.xlsx
2022-09-15,DB. COTAS,19911,0.0,66.48,12987.49,CRED CREA,Despesas financeiras,Despesas bancárias,../data/raw/BANCO CRED CREA -2022.xlsx
2022-09-16,CREDITO TED - PAGSEGURO INTERNET LTDA,33700185,1918.04,0.0,14905.53,CRED CREA,Despesas administrativas,Seguros,../data/raw/BANCO CRED CREA -2022.xlsx
2022-09-20,DB. ALLIANZ - SEGURO MOTO 6 DE 10,84624000166,0.0,157.91,14747.62,CRED CREA,Despesas administrativas,Seguros,../data/raw/BANCO CRED CREA -2022.xlsx
2022-09-22,CREDITO TED - PAGSEGURO INTERNET LTDA,33516597,515.43,0.0,15263.05,CRED CREA,Despesas administrativas,Seguros,../data/raw/BANCO CRED CREA -2022.xlsx
2022-09-26,CREDITO TED - PAGSEGURO INTERNET LTDA,34063304,667.3,0.0,15930.35,CRED CREA,Despesas administrativas,Seguros,../data/raw/BANCO CRED CREA -2022.xlsx
2022-09-30,CREDITO TED - PAGSEGURO INTERNET LTDA,34118659,693.25,0.0,16623.6,CRED CREA,Despesas administrativas,Seguros,../data/raw/BANCO CRED CREA -2022.xlsx
2022-10-06,PG.P/INTERNET - VALE TRANSPORTE MATEUS,10003619,0.0,167.94,16455.66,CRED CREA,Despesa com pessoal,Transporte (VT),../data/raw/BANCO CRED CREA -2022.xlsx
2022-10-06,PG.P/INTERNET - FGTS,10003641,0.0,1330.31,15125.35,CRED CREA,Despesa com pessoal,FGTS,../data/raw/BANCO CRED CREA -2022.xlsx
2022-10-07,CREDITO TED - PAGSEGURO INTERNET LTDA,34091133,1609.77,0.0,16735.12,CRED CREA,Despesas administrativas,Seguros,../data/raw/BANCO CRED CREA -2022.xlsx
2022-10-07,PG.P/INTERNET - PAGAMENTO ALUGUEL,10005204,0.0,4058.09,12677.03,CRED CREA,Despesas administrativas,Aluguel imóvel,../data/raw/BANCO CRED CREA -2022.xlsx
2022-10-07,PG.P/INTERNET - CIEE - ESTAGIARIOS,10005244,0.0,407.72,12269.31,CRED CREA,Despesa com pessoal,Salário,../data/raw/BANCO CRED CREA -2022.xlsx
2022-10-10,PREST.EMPREST 043/048,6,0.0,1418.47,10850.84,CRED CREA,Despesas financeiras,Emprestimo,../data/raw/BANCO CRED CREA -2022.xlsx
2022-10-10,DB. ALLIANZ - SEGURO SPIN 3 DE 10,84624000166,0.0,184.78,10666.06,CRED CREA,Despesas administrativas,Seguros,../data/raw/BANCO CRED CREA -2022.xlsx
2022-10-11,CREDITO TED - PAGSEGURO INTERNET LTDA,33583072,775.7,0.0,11441.76,CRED CREA,Despesas administrativas,Seguros,../data/raw/BANCO CRED CREA -2022.xlsx
2022-10-11,PG.P/INTERNET - WHITE MARTINS,10002363,0.0,100.0,11341.76,CRED CREA,Despesa com produtos,Materiais de Consumo,../data/raw/BANCO CRED CREA -2022.xlsx
2022-10-17,DB. COTAS,19911,0.0,66.48,11275.28,CRED CREA,Despesas financeiras,Despesas bancárias,../data/raw/BANCO CRED CREA -2022.xlsx
2022-10-17,CREDITO TED - PAGSEGURO INTERNET LTDA,34629762,1378.39,0.0,12653.67,CRED CREA,Despesas administrativas,Seguros,../data/raw/BANCO CRED CREA -2022.xlsx
2022-10-19,CREDITO TED - PAGSEGURO INTERNET LTDA,33991484,1902.77,0.0,14556.44,CRED CREA,Despesas administrativas,Seguros,../data/raw/BANCO CRED CREA -2022.xlsx
2022-10-19,PG.P/INTERNET - CARTAO INTER,10003978,0.0,3041.5,11514.94,CRED CREA,Despesas administrativas,Outras,../data/raw/BANCO CRED CREA -2022.xlsx
2022-10-20,DB. ALLIANZ - SEGURO MOTO 7 DE 10,84624000166,0.0,157.91,11357.03,CRED CREA,Despesas administrativas,Seguros,../data/raw/BANCO CRED CREA -2022.xlsx
2022-10-20,PG.P/INTERNET - Ligga telecon,10004175,0.0,149.9,11207.13,CRED CREA,Despesas administrativas,"Telefonia (Celular, Fixo, Internet)",../data/raw/BANCO CRED CREA -2022.xlsx
2022-10-20,PG.P/INTERNET - CELULAR,10004324,0.0,57.61,11149.52,CRED CREA,Despesas administrativas,"Telefonia (Celular, Fixo, Internet)",../data/raw/BANCO CRED CREA -2022.xlsx
2022-10-20,PG.P/INTERNET - NET FONE,10004258,0.0,123.6,11025.92,CRED CREA,Despesas administrativas,"Telefonia (Celular, Fixo, Internet)",../data/raw/BANCO CRED CREA -2022.xlsx
2022-10-25,CREDITO TED - PAGSEGURO INTERNET LTDA,33496112,1301.6,0.0,12327.52,CRED CREA,Despesas administrativas,Seguros,../data/raw/BANCO CRED CREA -2022.xlsx
2022-10-25,PG.P/INTERNET - MED CURITIBA,10002492,0.0,140.0,12187.52,CRED CREA,Despesas administrativas,Outras,../data/raw/BANCO CRED CREA -2022.xlsx
2022-10-27,CREDITO TED - PAGSEGURO INTERNET LTDA,33001800,1309.13,0.0,13496.65,CRED CREA,Despesas administrativas,Seguros,../data/raw/BANCO CRED CREA -2022.xlsx
2022-10-28,PG.P/INTERNET - VALE TRANSPORTE ESTAGIARIOS,10001882,0.0,882.94,12613.71,CRED CREA,Despesa com pessoal,Transporte (VT),../data/raw/BANCO CRED CREA -2022.xlsx
2022-10-31,PG.P/INTERNET - VR BENEFICIOS E SERV. DE PROC.,10005941,0.0,1100.0,11513.71,CRED CREA,Despesa com pessoal,Alimentação (VR VA),../data/raw/BANCO CRED CREA -2022.xlsx
2022-10-31,CREDITO TED - PAGSEGURO INTERNET LTDA,34478089,1242.85,0.0,12756.56,CRED CREA,Despesas administrativas,Seguros,../data/raw/BANCO CRED CREA -2022.xlsx
2022-11-01,CREDITO TED - PIC PAY,33711447,211.22,0.0,12967.78,CRED CREA,Receita com serviços,Outras,../data/raw/BANCO CRED CREA -2022.xlsx
2022-11-03,PG.P/INTERNET - VALE TRANSPORTE MARINA,10005708,0.0,211.94,12755.84,CRED CREA,Despesa com pessoal,Transporte (VT),../data/raw/BANCO CRED CREA -2022.xlsx
2022-11-03,PG.P/INTERNET - CONTA DE AGUA,10005729,0.0,189.21,12566.63,CRED CREA,Despesas administrativas,Água,../data/raw/BANCO CRED CREA -2022.xlsx
2022-11-03,PG.P/INTERNET - Guia de recolhimento,10006005,0.0,327.0,12239.63,CRED CREA,Despesas tributárias ,Outras,../data/raw/BANCO CRED CREA -2022.xlsx
2022-11-04,CREDITO TED - PAGSEGURO INTERNET LTDA,34133154,369.37,0.0,12609,CRED CREA,Despesas administrativas,Seguros,../data/raw/BANCO CRED CREA -2022.xlsx
2022-11-04,PG.P/INTERNET - WHITE MARTINS,10005495,0.0,30.9,12578.1,CRED CREA,Despesa com produtos,Materiais de Consumo,../data/raw/BANCO CRED CREA -2022.xlsx
2022-11-04,PG.P/INTERNET - FGTS,10005520,0.0,850.68,11727.42,CRED CREA,Despesa com pessoal,FGTS,../data/raw/BANCO CRED CREA -2022.xlsx
2022-11-07,PG.P/INTERNET - ALUGUEL,10012775,0.0,4458.18,7269.24,CRED CREA,Despesas administrativas,Aluguel imóvel,../data/raw/BANCO CRED CREA -2022.xlsx
2022-11-08,CREDITO TED - PAGSEGURO INTERNET LTDA,34213495,64.32,0.0,7333.56,CRED CREA,Despesas administrativas,Seguros,../data/raw/BANCO CRED CREA -2022.xlsx
2022-11-08,PG.P/INTERNET - CIEE - ESTAGIARIOS,10004924,0.0,1115.44,6218.12,CRED CREA,Despesa com pessoal,Salário,../data/raw/BANCO CRED CREA -2022.xlsx
2022-11-10,PREST.EMPREST 044/048,5,0.0,1418.47,4799.65,CRED CREA,Despesas financeiras,Emprestimo,../data/raw/BANCO CRED CREA -2022.xlsx
2022-11-10,DB. ALLIANZ  - SEGURO SPIN 4 DE 10,84624000166,0.0,184.78,4614.87,CRED CREA,Despesas administrativas,Seguros,../data/raw/BANCO CRED CREA -2022.xlsx
2022-11-14,CREDITO TED - PAGSEGURO INTERNET LTDA,34484762,631.85,0.0,5246.72,CRED CREA,Despesas administrativas,Seguros,../data/raw/BANCO CRED CREA -2022.xlsx
2022-11-14,PG.P/INTERNET - CARTAO AMERICAN,10006140,0.0,1679.89,3566.83,CRED CREA,Despesas administrativas,Outras,../data/raw/BANCO CRED CREA -2022.xlsx
2022-11-14,PG.P/INTERNET - MASTER FILME PARCELA 1 DE 3,10006177,0.0,514.5,3052.33,CRED CREA,Despesa com produtos,Materiais de Consumo,../data/raw/BANCO CRED CREA -2022.xlsx
2022-11-14,PG.P/INTERNET - PAGTO ENERGIA LJ 3,10006668,0.0,124.88,2927.45,CRED CREA,Despesas administrativas,Energia,../data/raw/BANCO CRED CREA -2022.xlsx
2022-11-14,PG.P/INTERNET - PAGTO ENERGIA LJ 4,10006703,0.0,83.23,2844.22,CRED CREA,Despesas administrativas,Energia,../data/raw/BANCO CRED CREA -2022.xlsx
2022-11-14,PG.P/INTERNET - PAGTO ENERGIA LJ 6,10006714,0.0,411.97,2432.25,CRED CREA,Despesas administrativas,Energia,../data/raw/BANCO CRED CREA -2022.xlsx
2022-11-16,DB. COTAS,19911,0.0,66.48,2365.77,CRED CREA,Despesas financeiras,Despesas bancárias,../data/raw/BANCO CRED CREA -2022.xlsx
2022-11-17,CREDITO TED - PAGSEGURO INTERNET LTDA,34085140,996.71,0.0,3362.48,CRED CREA,Despesas administrativas,Seguros,../data/raw/BANCO CRED CREA -2022.xlsx
2022-11-18,CREDITO TED - PAGSEGURO INTERNET LTDA,34089656,645.81,0.0,4008.29,CRED CREA,Despesas administrativas,Seguros,../data/raw/BANCO CRED CREA -2022.xlsx
2022-11-21,DB. ALLIANZ - SEGURO MOTO 8 DE 10,84624000166,0.0,157.91,3850.38,CRED CREA,Despesas administrativas,Seguros,../data/raw/BANCO CRED CREA -2022.xlsx
2022-11-21,PG.P/INTERNET - SPRINGER CARRIER,10007649,0.0,41.35,3809.03,CRED CREA,Despesa com serviços,Outras,../data/raw/BANCO CRED CREA -2022.xlsx
2022-11-22,CREDITO TED - PAGSEGURO INTERNET LTDA,33005125,710.32,0.0,4519.35,CRED CREA,Despesas administrativas,Seguros,../data/raw/BANCO CRED CREA -2022.xlsx
2022-11-22,PG.P/INTERNET - SPRINGER CARRIER,10001634,0.0,424.23,4095.12,CRED CREA,Despesa com serviços,Outras,../data/raw/BANCO CRED CREA -2022.xlsx
2022-11-22,PG.P/INTERNET - SPRINGER CARRIER,10001656,0.0,93.01,4002.11,CRED CREA,Despesa com serviços,Outras,../data/raw/BANCO CRED CREA -2022.xlsx
2022-11-23,CREDITO TED - PAGSEGURO INTERNET LTDA,34153165,821.1,0.0,4823.21,CRED CREA,Despesas administrativas,Seguros,../data/raw/BANCO CRED CREA -2022.xlsx
2022-12-05,CREDITO TED - PAGSEGURO INTERNET LTDA,34472255,946.92,0.0,5770.13,CRED CREA,Despesas administrativas,Seguros,../data/raw/BANCO CRED CREA -2022.xlsx
2022-12-05,PG.P/INTERNET - CONTA DE AGUA,10008541,0.0,189.21,5580.92,CRED CREA,Despesas administrativas,Água,../data/raw/BANCO CRED CREA -2022.xlsx
2022-12-08,CREDITO TED - PAGSEGURO INTERNET LTDA,33010172,1089.98,0.0,6670.9,CRED CREA,Despesas administrativas,Seguros,../data/raw/BANCO CRED CREA -2022.xlsx
2022-12-08,PG.P/INTERNET - ALUGUEL,10002118,0.0,4078.93,2591.97,CRED CREA,Despesas administrativas,Aluguel imóvel,../data/raw/BANCO CRED CREA -2022.xlsx
2022-12-08,PG.P/INTERNET - SPRINGER CARRIER,10002176,0.0,280.97,2311,CRED CREA,Despesa com serviços,Outras,../data/raw/BANCO CRED CREA -2022.xlsx
2022-12-08,PG.P/INTERNET - MASTER FILME C EMBALAGENS LTDA,10002145,0.0,514.5,1796.5,CRED CREA,Despesa com produtos,Materiais de Consumo,../data/raw/BANCO CRED CREA -2022.xlsx
2022-12-09,CREDITO TED - PAGSEGURO INTERNET LTDA,33900729,1349.74,0.0,3146.24,CRED CREA,Despesas administrativas,Seguros,../data/raw/BANCO CRED CREA -2022.xlsx
2022-12-09,PG.P/INTERNET - WHITE MARTINS,10003799,0.0,30.9,3115.34,CRED CREA,Despesa com produtos,Materiais de Consumo,../data/raw/BANCO CRED CREA -2022.xlsx
2022-12-12,PREST.EMPREST 045/048,6,0.0,1418.47,1696.87,CRED CREA,Despesas financeiras,Emprestimo,../data/raw/BANCO CRED CREA -2022.xlsx
2022-12-12,DB. ALLIANZ  - SEGURO SPIN 5 DE 10,84624000166,0.0,184.78,1512.09,CRED CREA,Despesas administrativas,Seguros,../data/raw/BANCO CRED CREA -2022.xlsx
2022-12-14,CREDITO TED - PAGSEGURO INTERNET LTDA,33694192,1269.64,0.0,2781.73,CRED CREA,Despesas administrativas,Seguros,../data/raw/BANCO CRED CREA -2022.xlsx
2022-12-14,PG.P/INTERNET - CARTAO AMERICAN,10005192,0.0,2555.4,226.33,CRED CREA,Despesas administrativas,Outras,../data/raw/BANCO CRED CREA -2022.xlsx
2022-12-15,DB. COTAS,19911,0.0,66.48,159.85,CRED CREA,Despesas financeiras,Despesas bancárias,../data/raw/BANCO CRED CREA -2022.xlsx
2022-12-15,CREDITO TED - PAGSEGURO INTERNET LTDA,34227763,164.22,0.0,324.07,CRED CREA,Despesas administrativas,Seguros,../data/raw/BANCO CRED CREA -2022.xlsx
2022-12-19,CREDITO TED - PAGSEGURO INTERNET LTDA,34554177,383.85,0.0,707.92,CRED CREA,Despesas administrativas,Seguros,../data/raw/BANCO CRED CREA -2022.xlsx
2022-12-20,DB. ALLIANZ - SEGURO MOTO 9 DE 10,84624000166,0.0,157.91,550.01,CRED CREA,Despesas administrativas,Seguros,../data/raw/BANCO CRED CREA -2022.xlsx
2022-12-20,PG.P/INTERNET - SPRINGER CARRIER,10012108,0.0,424.23,125.78,CRED CREA,Despesa com serviços,Outras,../data/raw/BANCO CRED CREA -2022.xlsx
2022-12-21,CREDITO TED - PAGSEGURO INTERNET LTDA,33019447,309.91,0.0,435.69,CRED CREA,Despesas administrativas,Seguros,../data/raw/BANCO CRED CREA -2022.xlsx
2022-12-22,CREDITO TED - PIC PAY,33695724,412.84,0.0,848.53,CRED CREA,Receita com serviços,Outras,../data/raw/BANCO CRED CREA -2022.xlsx
2022-12-22,PG.P/INTERNET - MED CURITIBA,10004271,0.0,383.0,465.53,CRED CREA,Despesas administrativas,Outras,../data/raw/BANCO CRED CREA -2022.xlsx
2022-01-05,DB CEST PJ,122021,0.0,69.0,"5.237,43",CAIXA,Despesas financeiras,Despesas bancárias,../data/raw/BANCO CAIXA - 2022.xlsx
2022-01-07,CRED TED PANASONIC DO BRASIL LTDA NFS-e 2123,341,5736.61,0.0,"10.974,04",CAIXA,Receita com serviços,Panasonic,../data/raw/BANCO CAIXA - 2022.xlsx
2022-01-07,PAG BOLETO - VT GUILHERME,407967,0.0,164.63,"10.809,41",CAIXA,Despesa com pessoal,Transporte (VT),../data/raw/BANCO CAIXA - 2022.xlsx
2022-01-07,DEB P FGTS,573806,0.0,1177.37,"9.632,04",CAIXA,Despesa com pessoal,FGTS,../data/raw/BANCO CAIXA - 2022.xlsx
2022-01-07,ENVIO TEV LUAN - PAGTO DE SALÁRIO,71329,0.0,546.5,"9.085,54",CAIXA,Despesa com pessoal,Salário,../data/raw/BANCO CAIXA - 2022.xlsx
2022-01-07,ENVIO TEV CONTABILIDADE - HONORÁRIOS,71343,0.0,712.0,"8.373,54",CAIXA,Despesas administrativas,Contabilidade,../data/raw/BANCO CAIXA - 2022.xlsx
2022-01-11,CRED TED FRESNOMAQ INDUSTRIA DE MAQUINA NFS-e 2117,341,5415.0,0.0,"13.788,54",CAIXA,Receita com serviços,FRESNOMAQ,../data/raw/BANCO CAIXA - 2022.xlsx
2022-01-14,CRED TEV RENATA LUCAS STOWE,140849,115.0,0.0,"13.903,54",CAIXA,Receita com serviços,Outras,../data/raw/BANCO CAIXA - 2022.xlsx
2022-01-14,CRED TEV JOVANI COMIRAN,141736,95.0,0.0,"13.998,54",CAIXA,Receita com serviços,Outras,../data/raw/BANCO CAIXA - 2022.xlsx
2022-01-14,PAG BOLETO SPRINGER CARRIER,390115,0.0,104.0,"13.894,54",CAIXA,Despesa com serviços,Spring,../data/raw/BANCO CAIXA - 2022.xlsx
2022-01-14,PAG BOLETO CARTÃO AMERICAN,394012,0.0,2649.25,"11.245,29",CAIXA,Despesas administrativas,Outras,../data/raw/BANCO CAIXA - 2022.xlsx
2022-01-14,PAG BOLETO CARSYSTEM 6/12,396425,0.0,94.0,"11.151,29",CAIXA,Despesas administrativas,Peças/acessórios veiculos,../data/raw/BANCO CAIXA - 2022.xlsx
2022-01-14,PAG BOLETO SPRINGER CARRIER,397710,0.0,124.58,"11.026,71",CAIXA,Despesa com serviços,Spring,../data/raw/BANCO CAIXA - 2022.xlsx
2022-01-14,PG LUZ/GAS ENERGIA LJ 3,925406,0.0,236.01,"10.790,70",CAIXA,Despesas administrativas,Energia,../data/raw/BANCO CAIXA - 2022.xlsx
2022-01-14,PG LUZ/GAS ENERGIA LJ 4,925867,0.0,121.14,"10.669,56",CAIXA,Despesas administrativas,Energia,../data/raw/BANCO CAIXA - 2022.xlsx
2022-01-14,PG LUZ/GAS ENERGIA LJ 6,926474,0.0,495.83,"10.173,73",CAIXA,Despesas administrativas,Energia,../data/raw/BANCO CAIXA - 2022.xlsx
2022-01-14,ENVIO PIX CARLOS PAGTO DESPESAS,142344,0.0,358.85,"9.814,88",CAIXA,Despesa com serviços,Outras,../data/raw/BANCO CAIXA - 2022.xlsx
2022-01-17,PAG BOLETO SPRINGER CARRIER,576887,0.0,105.82,"9.709,06",CAIXA,Despesa com serviços,Spring,../data/raw/BANCO CAIXA - 2022.xlsx
2022-01-18,CRED TED SPRINGER CARRIER LTDA NFS-e 2127,341,7188.12,0.0,"16.897,18",CAIXA,Receita com serviços,Spring,../data/raw/BANCO CAIXA - 2022.xlsx
2022-01-19,PAG BOLETO SPRINGER CARRIER,191647,0.0,139.89,"16.757,29",CAIXA,Despesa com serviços,Spring,../data/raw/BANCO CAIXA - 2022.xlsx
2022-01-19,PAG BOLETO SPRINGER CARRIER,191652,0.0,105.82,"16.651,47",CAIXA,Despesa com serviços,Spring,../data/raw/BANCO CAIXA - 2022.xlsx
2022-01-19,PG ORG GOV DAS,191655,0.0,2337.01,"14.314,46",CAIXA,Despesas tributárias ,Outras,../data/raw/BANCO CAIXA - 2022.xlsx
2022-01-19,PG ORG GOV DARF/GPS,191719,0.0,1175.99,"13.138,47",CAIXA,Despesas tributárias ,Outras,../data/raw/BANCO CAIXA - 2022.xlsx
2022-01-19,PG ORG GOV DARF - IRRF REF ALUGUEL IMÓVEL,191723,0.0,84.58,"13.053,89",CAIXA,Despesas tributárias ,Outras,../data/raw/BANCO CAIXA - 2022.xlsx
2022-01-19,PAG BOLETO CARTÃO INTER,191728,0.0,1566.66,"11.487,23",CAIXA,Despesas administrativas,Outras,../data/raw/BANCO CAIXA - 2022.xlsx
2022-01-20,CRED TED ELGIN S A MATRIZ,341,129.0,0.0,"11.616,23",CAIXA,Receita com serviços,Elgin,../data/raw/BANCO CAIXA - 2022.xlsx
2022-01-20,ENVIO TEV LUAN - ADIANTAMENTO QUINZENAL,201153,0.0,557.18,"11.059,05",CAIXA,Despesa com pessoal,Salário,../data/raw/BANCO CAIXA - 2022.xlsx
2022-01-20,ENVIO PIX GUILHERME - DESPESAS,202344,0.0,1010.96,"10.048,09",CAIXA,Despesa com serviços,Outras,../data/raw/BANCO CAIXA - 2022.xlsx
2022-01-21,ENVIO PIX TAMYELLE - COMPRA HD,211611,0.0,355.0,"9.693,09",CAIXA,Despesa com serviços,Outras,../data/raw/BANCO CAIXA - 2022.xlsx
2022-01-21,PAG AGUA,211940,0.0,310.89,"9.382,20",CAIXA,Despesas administrativas,Água,../data/raw/BANCO CAIXA - 2022.xlsx
2022-01-24,PAG FONE CELULAR,241449,0.0,64.98,"9.317,22",CAIXA,Despesas administrativas,"Telefonia (Celular, Fixo, Internet)",../data/raw/BANCO CAIXA - 2022.xlsx
2022-01-24,PAG FONE CELULAR,241451,0.0,54.99,"9.262,23",CAIXA,Despesas administrativas,"Telefonia (Celular, Fixo, Internet)",../data/raw/BANCO CAIXA - 2022.xlsx
2022-01-24,PAG FONE COPEL FIBRA-INTERNET,241453,0.0,149.9,"9.112,33",CAIXA,Despesas administrativas,"Telefonia (Celular, Fixo, Internet)",../data/raw/BANCO CAIXA - 2022.xlsx
2022-01-24,PAG FONE NET FONE,241454,0.0,139.88,"8.972,45",CAIXA,Despesas administrativas,"Telefonia (Celular, Fixo, Internet)",../data/raw/BANCO CAIXA - 2022.xlsx
2022-01-24,PAG BOLETO WHITE MARTINS,241459,0.0,201.47,"8.770,98",CAIXA,Despesa com produtos,Materiais de Consumo,../data/raw/BANCO CAIXA - 2022.xlsx
2022-01-24,PAG BOLETO SPRINGER CARRIER,241500,0.0,191.84,"8.579,14",CAIXA,Despesa com serviços,Spring,../data/raw/BANCO CAIXA - 2022.xlsx
2022-01-24,PAG BOLETO SPRINGER CARRIER,241512,0.0,430.36,"8.148,78",CAIXA,Despesa com serviços,Spring,../data/raw/BANCO CAIXA - 2022.xlsx
2022-01-31,CRED TEV IVERSON LADEWIG,291403,200.0,0.0,"8.348,78",CAIXA,Receita com serviços,Outras,../data/raw/BANCO CAIXA - 2022.xlsx
2022-02-02,CRED TED RODOLFO ARTHUR ZUCKERMANN,33,40.0,0.0,"8.388,78",CAIXA,Receita com serviços,Outras,../data/raw/BANCO CAIXA - 2022.xlsx
2022-02-02,PAG BOLETO SPRINGER CARRIER,21444,0.0,26.01,"8.362,77",CAIXA,Despesa com serviços,Spring,../data/raw/BANCO CAIXA - 2022.xlsx
2022-02-03,CRED TEV SONIA DE FATIMA LEHMANN,31918,300.0,0.0,"8.662,77",CAIXA,Receita com serviços,Outras,../data/raw/BANCO CAIXA - 2022.xlsx
2022-02-04,ENVIO PIX CARLOS - PAGTO DE SALÁRIO,41123,0.0,2137.17,"6.525,60",CAIXA,Despesa com pessoal,Salário,../data/raw/BANCO CAIXA - 2022.xlsx
2022-02-04,ENVIO TEV LUAN - PAGTO DE SALÁRIO,41136,0.0,726.62,"5.798,98",CAIXA,Despesa com pessoal,Salário,../data/raw/BANCO CAIXA - 2022.xlsx
2022-02-04,ENVIO PIX FERNANDA - PAGTO DE SALÁRIO,41139,0.0,1197.03,"4.601,95",CAIXA,Despesa com pessoal,Salário,../data/raw/BANCO CAIXA - 2022.xlsx
2022-02-04,ENVIO PIX GUILHERME - PAGTO DE SALÁRIO,41157,0.0,1266.09,"3.335,86",CAIXA,Despesa com pessoal,Salário,../data/raw/BANCO CAIXA - 2022.xlsx
2022-02-04,PAG FGTS,41202,0.0,966.32,"2.369,54",CAIXA,Despesa com pessoal,FGTS,../data/raw/BANCO CAIXA - 2022.xlsx
2022-02-04,CRED TEV CREONICE APARECIDA ANTUNES DE SO,41748,120.0,0.0,"2.489,54",CAIXA,Receita com serviços,Outras,../data/raw/BANCO CAIXA - 2022.xlsx
2022-02-04,ENVIO TEV CONTABILIDADE - HONORÁRIOS,41926,0.0,491.5,"1.998,04",CAIXA,Despesas administrativas,Contabilidade,../data/raw/BANCO CAIXA - 2022.xlsx
2022-02-04,ENVIO TEV LUAN - BÔNUS,41941,0.0,313.36,"1.684,68",CAIXA,Despesa com pessoal,Outras,../data/raw/BANCO CAIXA - 2022.xlsx
2022-02-07,CRED TED PAGSEGURO INTERNET LTDA,290,292.83,0.0,"1.977,51",CAIXA,Receita com serviços,Outras,../data/raw/BANCO CAIXA - 2022.xlsx
2022-02-07,CRED TED SPRINGER CARRIER LTDA NFS-e 2136,341,11982.55,0.0,"13.960,06",CAIXA,Receita com serviços,Spring,../data/raw/BANCO CAIXA - 2022.xlsx
2022-02-07,ENVIO PIX ELISABETE - PRO-LABORE,72344,0.0,1078.68,"12.881,38",CAIXA,Despesa com pessoal,Pró labore,../data/raw/BANCO CAIXA - 2022.xlsx
2022-02-07,DB CEST PJ,12022,0.0,69.0,"12.812,38",CAIXA,Despesas financeiras,Despesas bancárias,../data/raw/BANCO CAIXA - 2022.xlsx
2022-02-10,CRED TED PANASONIC DO BRASIL NFS-e 2132,341,3339.51,0.0,"16.151,89",CAIXA,Receita com serviços,Panasonic,../data/raw/BANCO CAIXA - 2022.xlsx
2022-02-11,CRED TED FRESNOMAQ INDUSTRIA DE MAQUINA NFS-e 2126,341,6121.0,0.0,"22.272,89",CAIXA,Receita com serviços,FRESNOMAQ,../data/raw/BANCO CAIXA - 2022.xlsx
2022-02-14,CRED TED DOMINGOS B V SEVERINO,1,65.0,0.0,"22.337,89",CAIXA,Receita com serviços,Outras,../data/raw/BANCO CAIXA - 2022.xlsx
2022-02-14,PG LUZ/GAS - ENERGIA LJ 3,271606,0.0,175.74,"22.162,15",CAIXA,Despesas administrativas,Energia,../data/raw/BANCO CAIXA - 2022.xlsx
2022-02-14,PG LUZ/GAS - ENERGIA LJ 4,272211,0.0,34.92,"22.127,23",CAIXA,Despesas administrativas,Energia,../data/raw/BANCO CAIXA - 2022.xlsx
2022-02-14,PG LUZ/GAS - ENERGIA LJ 6,273372,0.0,497.01,"21.630,22",CAIXA,Despesas administrativas,Energia,../data/raw/BANCO CAIXA - 2022.xlsx
2022-02-14,PAG BOLETO PACKPAR EMBALAGENS,936670,0.0,805.0,"20.825,22",CAIXA,Despesa com produtos,Materiais de Consumo,../data/raw/BANCO CAIXA - 2022.xlsx
2022-02-14,PAG BOLETO SPRINGER CARRIER,948503,0.0,139.89,"20.685,33",CAIXA,Despesa com serviços,Spring,../data/raw/BANCO CAIXA - 2022.xlsx
2022-02-15,DP DIN LOT CLIENTE,151035,177.5,0.0,"20.862,83",CAIXA,Receita com serviços,Outras,../data/raw/BANCO CAIXA - 2022.xlsx
2022-02-15,PAG BOLETO CARTÃO AMERICAN,151620,0.0,2634.08,"18.228,75",CAIXA,Despesas administrativas,Outras,../data/raw/BANCO CAIXA - 2022.xlsx
2022-02-15,PAG BOLETO SPRINGER CARRIER,151623,0.0,105.82,"18.122,93",CAIXA,Despesa com serviços,Spring,../data/raw/BANCO CAIXA - 2022.xlsx
2022-02-15,PAG BOLETO SPRINGER CARRIER,151626,0.0,177.96,"17.944,97",CAIXA,Despesa com serviços,Spring,../data/raw/BANCO CAIXA - 2022.xlsx
2022-02-15,PG ORG GOV DARF/GPS,151632,0.0,1219.28,"16.725,69",CAIXA,Despesas tributárias ,Outras,../data/raw/BANCO CAIXA - 2022.xlsx
2022-02-17,PG ORG GOV DARF - IRRF REF ALUGUEL IMÓVEL,171852,0.0,84.58,"16.641,11",CAIXA,Despesas tributárias ,Outras,../data/raw/BANCO CAIXA - 2022.xlsx
2022-02-18,CRED TED SONIA DE FATIMA LEHMANN,33,385.0,0.0,"17.026,11",CAIXA,Receita com serviços,Outras,../data/raw/BANCO CAIXA - 2022.xlsx
2022-02-21,PG ORG GOV SIMPLES NACIONAL,191044,0.0,2325.66,"14.700,45",CAIXA,Despesas tributárias ,Outras,../data/raw/BANCO CAIXA - 2022.xlsx
2022-02-21,PAG BOLETO EMBALATEC,210738,0.0,2887.72,"11.812,73",CAIXA,Despesa com produtos,Materiais de Consumo,../data/raw/BANCO CAIXA - 2022.xlsx
2022-02-21,CRED TED CATIA FRANCO DE SOUZA,237,190.0,0.0,"12.002,73",CAIXA,Receita com serviços,Outras,../data/raw/BANCO CAIXA - 2022.xlsx
2022-02-21,CRED TED PICPAY SERVICOS S A - ALANA,380,417.14,0.0,"12.419,87",CAIXA,Receita com serviços,Outras,../data/raw/BANCO CAIXA - 2022.xlsx
2022-02-21,CRED TED PICPAY SERVICOS S A - JACQUELINE,380,392.89,0.0,"12.812,76",CAIXA,Receita com serviços,Outras,../data/raw/BANCO CAIXA - 2022.xlsx
2022-02-21,CRED TED FRESNOMAQ INDUSTRIA DE MAQUINA NFS-e 2135,341,6835.0,0.0,"19.647,76",CAIXA,Receita com serviços,FRESNOMAQ,../data/raw/BANCO CAIXA - 2022.xlsx
2022-02-21,PAG BOLETO ROCKTEC,211914,0.0,451.99,"19.195,77",CAIXA,Despesa com serviços,Outras,../data/raw/BANCO CAIXA - 2022.xlsx
2022-03-02,CRED TED PICPAY SERVICOS S A ,380,213.42,0.0,"19.409,19",CAIXA,Receita com serviços,Outras,../data/raw/BANCO CAIXA - 2022.xlsx
2022-03-04,ENVIO TEV LUAN - SALÁRIO AUXÍLIO ATESTADO,41409,0.0,535.18,"18.874,01",CAIXA,Despesa com pessoal,Salário,../data/raw/BANCO CAIXA - 2022.xlsx
2022-03-04,ENVIO TEV FERNANDO - PAGTO DE SALÁRIO,41411,0.0,528.57,"18.345,44",CAIXA,Despesa com pessoal,Salário,../data/raw/BANCO CAIXA - 2022.xlsx
2022-03-04,ENVIO PIX FERNANDA - PAGTO SALÁRIO,41415,0.0,1373.21,"16.972,23",CAIXA,Despesa com pessoal,Salário,../data/raw/BANCO CAIXA - 2022.xlsx
2022-03-04,ENVIO PIX TATYANA - PAGTO SALÁRIO,41419,0.0,1428.43,"15.543,80",CAIXA,Despesa com pessoal,Salário,../data/raw/BANCO CAIXA - 2022.xlsx
2022-03-04,ENVIO PIX BEATRIZ - PAGTO SALÁRIO,41424,0.0,1017.5,"14.526,30",CAIXA,Despesa com pessoal,Salário,../data/raw/BANCO CAIXA - 2022.xlsx
2022-03-04,ENVIO PIX LUIZ - PAGTO SALÁRIO,41427,0.0,979.02,"13.547,28",CAIXA,Despesa com pessoal,Salário,../data/raw/BANCO CAIXA - 2022.xlsx
2022-03-07,PAG DARF - IRRF,439473,0.0,30.35,"13.516,93",CAIXA,Despesas tributárias ,Outras,../data/raw/BANCO CAIXA - 2022.xlsx
2022-03-07,DEB P FGTS,534246,0.0,1002.99,"12.513,94",CAIXA,Despesa com pessoal,FGTS,../data/raw/BANCO CAIXA - 2022.xlsx
2022-03-07,ENVIO TEV HONORÁRIOS CONTABILIDADE,71745,0.0,766.5,"11.747,44",CAIXA,Despesas administrativas,Contabilidade,../data/raw/BANCO CAIXA - 2022.xlsx
2022-03-07,ENVIO PIX CARLOS - PAGTO RESCISÃO,72343,0.0,3403.82,"8.343,62",CAIXA,Despesa com pessoal,Aviso prévio / Multa rescisória,../data/raw/BANCO CAIXA - 2022.xlsx
2022-03-07,DB CEST PJ,22022,0.0,69.0,"8.274,62",CAIXA,Despesas financeiras,Despesas bancárias,../data/raw/BANCO CAIXA - 2022.xlsx
2022-03-08,CRED TED JANISKI RET DE MOT DIESEL- NFS-e 2145 E NF-e 3654,341,1280.0,0.0,"9.554,62",CAIXA,Receita com serviços,Outras,../data/raw/BANCO CAIXA - 2022.xlsx
2022-03-08,ENVIO PIX BETE PRO-LABORE,82343,0.0,1078.68,"8.475,94",CAIXA,Despesa com pessoal,Pró labore,../data/raw/BANCO CAIXA - 2022.xlsx
2022-03-08,ENVIO PIX CLAUDIO PRO-LABORE,82343,0.0,1078.68,"7.397,26",CAIXA,Despesa com pessoal,Pró labore,../data/raw/BANCO CAIXA - 2022.xlsx
2022-03-10,CRED TED PANASONIC DO BRASIL LIMITADA NFS-e 2141,341,4374.49,0.0,"11.771,75",CAIXA,Receita com serviços,Panasonic,../data/raw/BANCO CAIXA - 2022.xlsx
2022-03-10,CRED TED SPRINGER CARRIER LTDA NFS-e 2146,341,5535.6,0.0,"17.307,35",CAIXA,Receita com serviços,Spring,../data/raw/BANCO CAIXA - 2022.xlsx
2022-03-14,PAG AGUA,141613,0.0,13.05,"17.294,30",CAIXA,Despesas administrativas,Água,../data/raw/BANCO CAIXA - 2022.xlsx
2022-03-14,PAG BOLETO CARTÃO AMERICAN,141617,0.0,3460.64,"13.833,66",CAIXA,Despesas administrativas,Outras,../data/raw/BANCO CAIXA - 2022.xlsx
2022-03-14,PG LUZ/GAS - ENERGIA LJ 3,141619,0.0,283.42,"13.550,24",CAIXA,Despesas administrativas,Energia,../data/raw/BANCO CAIXA - 2022.xlsx
2022-03-14,PG LUZ/GAS - ENERGIA LJ 4,141621,0.0,83.2,"13.467,04",CAIXA,Despesas administrativas,Energia,../data/raw/BANCO CAIXA - 2022.xlsx
2022-03-14,PG LUZ/GAS - ENERGIA LJ 6,141623,0.0,594.71,"12.872,33",CAIXA,Despesas administrativas,Energia,../data/raw/BANCO CAIXA - 2022.xlsx
2022-03-14,PG ORG GOV DARF/GPS,141627,0.0,1151.06,"11.721,27",CAIXA,Despesas tributárias ,Outras,../data/raw/BANCO CAIXA - 2022.xlsx
2022-03-14,PAG DARF - IRRF REF ALUGUEL IMÓVEL,141638,0.0,84.58,"11.636,69",CAIXA,Despesas tributárias ,Outras,../data/raw/BANCO CAIXA - 2022.xlsx
2022-03-18,PG ORG GOV - DAS,181636,0.0,2988.97,"8.647,72",CAIXA,Despesas tributárias ,Outras,../data/raw/BANCO CAIXA - 2022.xlsx
2022-03-21, CRED TED BRASANITAS HOSP. HIG. - NFS-e 2144 E NF-e 3648,237,1488.8,0.0,"10.136,52",CAIXA,Receita com serviços,Outras,../data/raw/BANCO CAIXA - 2022.xlsx
2022-03-21,CRED TED PAGSEGURO ,290,1191.44,0.0,"11.327,96",CAIXA,Receita com serviços,Outras,../data/raw/BANCO CAIXA - 2022.xlsx
2022-03-21,ENVIO PIX RAMON - ADIANTAMENTO QUINZENAL,212344,0.0,567.74,"10.760,22",CAIXA,Despesa com pessoal,Salário,../data/raw/BANCO CAIXA - 2022.xlsx
2022-03-22,CRED TED PICPAY SERVICOS S A,380,748.88,0.0,"11.509,10",CAIXA,Receita com serviços,Outras,../data/raw/BANCO CAIXA - 2022.xlsx
2022-03-24,CRED TED HORFRAN COM ELETRO MOVEIS LTDA- NF-e 3667,341,195.0,0.0,"11.704,10",CAIXA,Receita com serviços,Outras,../data/raw/BANCO CAIXA - 2022.xlsx
2022-03-28,"CRED TED PICPAY SERVICOS S A
",380,240.0,0.0,"11.944,10",CAIXA,Receita com serviços,Outras,../data/raw/BANCO CAIXA - 2022.xlsx
2022-03-31,CRED TED MARIANGELA GONCALVES,1,330.0,0.0,"12.274,10",CAIXA,Receita com serviços,Outras,../data/raw/BANCO CAIXA - 2022.xlsx
2022-04-05,ENVIO TEV CONTABILIDADE ,52034,0.0,491.5,"11.782,60",CAIXA,Despesas administrativas,Contabilidade,../data/raw/BANCO CAIXA - 2022.xlsx
2022-04-05,DB CEST PJ,32022,0.0,69.0,"11.713,60",CAIXA,Despesas financeiras,Despesas bancárias,../data/raw/BANCO CAIXA - 2022.xlsx
2022-04-06,ENVIO TEV MÔNICA - PAGTO SALÁRIO,61150,0.0,191.16,"11.522,44",CAIXA,Despesa com pessoal,Salário,../data/raw/BANCO CAIXA - 2022.xlsx
2022-04-06,ENVIO PIX MATHEUS - PAGTO SALÁRIO,62337,0.0,1519.56,"10.002,88",CAIXA,Despesa com pessoal,Salário,../data/raw/BANCO CAIXA - 2022.xlsx
2022-04-06,ENVIO PIX RAMON - PAGTO SALÁRIO,62337,0.0,951.51,"9.051,37",CAIXA,Despesa com pessoal,Salário,../data/raw/BANCO CAIXA - 2022.xlsx
2022-04-06,ENVIO PIX LUIZ - PAGTO SALÁRIO,62337,0.0,1003.03,"8.048,34",CAIXA,Despesa com pessoal,Salário,../data/raw/BANCO CAIXA - 2022.xlsx
2022-04-06,ENVIO PIX BEATRIZ - PAGTO SALÁRIO,62337,0.0,926.57,"7.121,77",CAIXA,Despesa com pessoal,Salário,../data/raw/BANCO CAIXA - 2022.xlsx
2022-04-07,CRED TED PICPAY SERVICOS S A,380,499.25,0.0,"7.621,02",CAIXA,Receita com serviços,Outras,../data/raw/BANCO CAIXA - 2022.xlsx
2022-04-07,DEB P FGTS,571345,0.0,917.58,"6.703,44",CAIXA,Despesa com pessoal,FGTS,../data/raw/BANCO CAIXA - 2022.xlsx
2022-04-07,ENVIO PIX CLAUDIO PRO-LABORE,72344,0.0,1078.68,"5.624,76",CAIXA,Despesa com pessoal,Pró labore,../data/raw/BANCO CAIXA - 2022.xlsx
2022-04-07,ENVIO PIX BETE PRO-LABORE,72344,0.0,1078.68,"4.546,08",CAIXA,Despesa com pessoal,Pró labore,../data/raw/BANCO CAIXA - 2022.xlsx
2022-04-11,CRED TED PANASONIC DO BRASIL LIMITADA NFS-e 2149,341,2268.03,0.0,"6.814,11",CAIXA,Receita com serviços,Panasonic,../data/raw/BANCO CAIXA - 2022.xlsx
2022-04-11,CRED TED FRESNOMAQ IND. DE MAQUINA NFS-e 2148,341,7222.0,0.0,"14.036,11",CAIXA,Receita com serviços,FRESNOMAQ,../data/raw/BANCO CAIXA - 2022.xlsx
2022-04-12,PAG BOLETO CARTÃO AMERICAN,403374,0.0,4947.38,"9.088,73",CAIXA,Despesas administrativas,Outras,../data/raw/BANCO CAIXA - 2022.xlsx
2022-04-12,PAG BOLETO EMBALATEC,514118,0.0,3305.7,"5.783,03",CAIXA,Despesa com produtos,Materiais de Consumo,../data/raw/BANCO CAIXA - 2022.xlsx
2022-04-12,ENVIO PIX BEATRIZ - PAGTO RESCISÃO,122344,0.0,759.11,"5.023,92",CAIXA,Despesa com pessoal,Aviso prévio / Multa rescisória,../data/raw/BANCO CAIXA - 2022.xlsx
2022-04-13,SAQUE ATM P/ PAGTO DIVERSOS,131146,0.0,1100.0,"3.923,92",CAIXA,Despesas administrativas,Outras,../data/raw/BANCO CAIXA - 2022.xlsx
2022-04-19,PG ORG GOV DARF/GPS,191558,0.0,1021.68,"2.902,24",CAIXA,Despesas tributárias ,Outras,../data/raw/BANCO CAIXA - 2022.xlsx
2022-04-20,CRED TED FRESNOMAQ IND. DE MAQUINA NFS-e 2154,341,16472.4,0.0,"19.374,64",CAIXA,Receita com serviços,FRESNOMAQ,../data/raw/BANCO CAIXA - 2022.xlsx
2022-04-22,PAG FONE CELULAR,335772,0.0,72.99,"19.301,65",CAIXA,Despesas administrativas,"Telefonia (Celular, Fixo, Internet)",../data/raw/BANCO CAIXA - 2022.xlsx
2022-04-22,PAG BOLETO SINDMED - MED CURITIBA ,508315,0.0,313.0,"18.988,65",CAIXA,Despesa com pessoal,Assistência médica,../data/raw/BANCO CAIXA - 2022.xlsx
2022-04-22,PAG BOLETO SPRINGER CARRIER,510357,0.0,183.61,"18.805,04",CAIXA,Despesa com serviços,Spring,../data/raw/BANCO CAIXA - 2022.xlsx
2022-04-28,CRED TED SPRINGER CARRIER LTDA NFS-e 2153,341,13251.26,0.0,"32.056,30",CAIXA,Receita com serviços,Spring,../data/raw/BANCO CAIXA - 2022.xlsx
2022-05-02,PAG BOLETO SPRINGER CARRIER,21148,0.0,335.08,"31.721,22",CAIXA,Despesa com serviços,Spring,../data/raw/BANCO CAIXA - 2022.xlsx
2022-05-02,PAG BOLETO VALE TRANSPORTE LUIZ,21150,0.0,244.63,"31.476,59",CAIXA,Despesa com pessoal,Transporte (VT),../data/raw/BANCO CAIXA - 2022.xlsx
2022-05-02,PAG BOLETO PNEU FREE,708665,0.0,2124.3,"29.352,29",CAIXA,Despesas administrativas,Peças/acessórios veiculos,../data/raw/BANCO CAIXA - 2022.xlsx
2022-05-03,PAG BOLETO FRESNOMAQ-WAP,31636,0.0,122.03,"29.230,26",CAIXA,Despesa com serviços,Fresnomaq,../data/raw/BANCO CAIXA - 2022.xlsx
2022-05-05,DOC ELET PEDRO HENRIQUE XAVIER NFS-e 2163,971219,1290.0,0.0,"30.520,26",CAIXA,Receita com serviços,Outras,../data/raw/BANCO CAIXA - 2022.xlsx
2022-05-05,DEB P FGTS MULTA RESCISÃO MÔNICA,584238,0.0,198.34,"30.321,92",CAIXA,Despesa com pessoal,FGTS,../data/raw/BANCO CAIXA - 2022.xlsx
2022-05-05,DEB P FGTS,584388,0.0,893.84,"29.428,08",CAIXA,Despesa com pessoal,FGTS,../data/raw/BANCO CAIXA - 2022.xlsx
2022-05-05,PAG BOLETO CIEE ESTAGIÁRIOS,639399,0.0,533.05,"28.895,03",CAIXA,Despesa com pessoal,CIEE (Estagiario),../data/raw/BANCO CAIXA - 2022.xlsx
2022-05-05,PAG AGUA,852681,0.0,158.29,"28.736,74",CAIXA,Despesas administrativas,Água,../data/raw/BANCO CAIXA - 2022.xlsx
2022-05-05,ENVIO TEV SILVIA HONORÁRIOS CONTABILIDADE,51541,0.0,491.5,"28.245,24",CAIXA,Despesas administrativas,Contabilidade,../data/raw/BANCO CAIXA - 2022.xlsx
2022-05-05,DB CEST PJ,42022,0.0,69.0,"28.176,24",CAIXA,Despesas financeiras,Despesas bancárias,../data/raw/BANCO CAIXA - 2022.xlsx
2022-05-06,SAQUE LOT P/ PAGAMENTOS DIVERSOS,61306,0.0,1000.0,"27.176,24",CAIXA,Despesas administrativas,Outras,../data/raw/BANCO CAIXA - 2022.xlsx
2022-05-06,ENVIO TEV LUAN - PAGTO DE SALÁRIO,61132,0.0,166.5,"27.009,74",CAIXA,Despesa com pessoal,Salário,../data/raw/BANCO CAIXA - 2022.xlsx
2022-05-06,ENVIO TEV MÔNICA - PAGTO DE RESCISÃO CONTRATO,61135,0.0,2077.68,"24.932,06",CAIXA,Despesa com pessoal,Aviso prévio / Multa rescisória,../data/raw/BANCO CAIXA - 2022.xlsx
2022-05-06,ENVIO PIX RAMON - PAGTO DE SALÁRIO,61225,0.0,1055.47,"23.876,59",CAIXA,Despesa com pessoal,Salário,../data/raw/BANCO CAIXA - 2022.xlsx
2022-05-06,ENVIO PIX ELISABETE - PAGTO PRO-LABORE,61235,0.0,1078.68,"22.797,91",CAIXA,Despesa com pessoal,Pró labore,../data/raw/BANCO CAIXA - 2022.xlsx
2022-05-06,ENVIO PIX CLAUDIO - PAGTO PRO-LABORE,61238,0.0,1078.68,"21.719,23",CAIXA,Despesa com pessoal,Pró labore,../data/raw/BANCO CAIXA - 2022.xlsx
2022-05-09,PAG BOLETO WHITE MARTINS,360195,0.0,30.9,"21.688,33",CAIXA,Despesa com produtos,Materiais de Consumo,../data/raw/BANCO CAIXA - 2022.xlsx
2022-05-10,CRED TED PANASONIC DO BRASIL LIMITADA NFS-e 2158,341,1792.58,0.0,"23.480,91",CAIXA,Receita com serviços,Panasonic,../data/raw/BANCO CAIXA - 2022.xlsx
2022-05-11,CRED TED SPRINGER CARRIER LTDA NFS-e 2161,341,6820.94,0.0,"30.301,85",CAIXA,Receita com serviços,Spring,../data/raw/BANCO CAIXA - 2022.xlsx
2022-05-12,CRED TED BRASANITAS HOSPITALAR HIGIEN NFS-e 2157,237,700.0,0.0,"31.001,85",CAIXA,Receita com serviços,Outras,../data/raw/BANCO CAIXA - 2022.xlsx
2022-05-12,PIX ENVIADO NAKAYOSHI IMOVEIS - PAGTO ALUGUEL,121023,0.0,4067.09,"26.934,76",CAIXA,Despesas administrativas,Aluguel imóvel,../data/raw/BANCO CAIXA - 2022.xlsx
2022-05-13,PIX ENVIADO RAMON - ADIANTAMENTO DE SALÁRIO,131507,0.0,850.0,"26.084,76",CAIXA,Despesa com pessoal,Salário,../data/raw/BANCO CAIXA - 2022.xlsx
2022-05-16,PAG BOLETO SPRINGER CARRIER,60973,0.0,29.45,"26.055,31",CAIXA,Despesa com serviços,Spring,../data/raw/BANCO CAIXA - 2022.xlsx
2022-05-16,PG LUZ/GAS ENERGIA LJ 3,440102,0.0,150.07,"25.905,24",CAIXA,Despesas administrativas,Energia,../data/raw/BANCO CAIXA - 2022.xlsx
2022-05-16,PG LUZ/GAS ENERGIA LJ 4,443169,0.0,111.74,"25.793,50",CAIXA,Despesas administrativas,Energia,../data/raw/BANCO CAIXA - 2022.xlsx
2022-05-16,PG LUZ/GAS ENERGIA LJ 6,444176,0.0,420.0,"25.373,50",CAIXA,Despesas administrativas,Energia,../data/raw/BANCO CAIXA - 2022.xlsx
2022-05-16,PAG BOLETO CARTÃO AMERICAN,996193,0.0,2753.09,"22.620,41",CAIXA,Despesas administrativas,Outras,../data/raw/BANCO CAIXA - 2022.xlsx
2022-05-17,CRED TED ELGIN S A,237,83.0,0.0,"22.703,41",CAIXA,Receita com serviços,Elgin,../data/raw/BANCO CAIXA - 2022.xlsx
2022-05-19,CRED TED VACCINAR INDUSTRIA E COMERCIO NFS-e 2167,341,10000.0,0.0,"32.703,41",CAIXA,Receita com serviços,Outras,../data/raw/BANCO CAIXA - 2022.xlsx
2022-05-19,PG ORG GOV DARF - IRRF REF ALUGUEL IMÓVEL,74902,0.0,84.58,"32.618,83",CAIXA,Despesas tributárias ,Outras,../data/raw/BANCO CAIXA - 2022.xlsx
2022-05-19,PG ORG GOV DARF/GPS,75178,0.0,1160.33,"31.458,50",CAIXA,Despesas tributárias ,Outras,../data/raw/BANCO CAIXA - 2022.xlsx
2022-05-19,PG ORG GOV DAS,113577,0.0,3280.8,"28.177,70",CAIXA,Despesas tributárias ,Outras,../data/raw/BANCO CAIXA - 2022.xlsx
2022-05-19,PAG FONE NET FONE,115753,0.0,139.88,"28.037,82",CAIXA,Despesas administrativas,"Telefonia (Celular, Fixo, Internet)",../data/raw/BANCO CAIXA - 2022.xlsx
2022-05-19,PAG FONE CELULAR,116527,0.0,72.99,"27.964,83",CAIXA,Despesas administrativas,"Telefonia (Celular, Fixo, Internet)",../data/raw/BANCO CAIXA - 2022.xlsx
2022-05-19,PAG BOLETO SPRINGER CARRIER,317928,0.0,49.74,"27.915,09",CAIXA,Despesa com serviços,Spring,../data/raw/BANCO CAIXA - 2022.xlsx
2022-05-19,PAG BOLETO CARTÃO INTER,320370,0.0,2593.71,"25.321,38",CAIXA,Despesas administrativas,Outras,../data/raw/BANCO CAIXA - 2022.xlsx
2022-05-19,PAG BOLETO WHITE MARTINS,333982,0.0,112.5,"25.208,88",CAIXA,Despesa com produtos,Materiais de Consumo,../data/raw/BANCO CAIXA - 2022.xlsx
2022-05-19,PAG BOLETO SINDMED - MED CURITIBA ,336193,0.0,110.0,"25.098,88",CAIXA,Despesa com pessoal,Assistência médica,../data/raw/BANCO CAIXA - 2022.xlsx
2022-05-19,ENVIO TEV LUAN - ADIANTAMENTO DE SALÁRIO,191641,0.0,720.0,"24.378,88",CAIXA,Despesa com pessoal,Salário,../data/raw/BANCO CAIXA - 2022.xlsx
2022-05-20,CRED TED HORFRAN COM ELETRO MOVEIS  NF-e 3706 e 3707,341,140.0,0.0,"24.518,88",CAIXA,Receita com serviços,Outras,../data/raw/BANCO CAIXA - 2022.xlsx
2022-05-23,CRED TED FRESNOMAQ IND. DE MAQUINA NFS-e 2164,341,7311.0,0.0,"31.829,88",CAIXA,Receita com serviços,FRESNOMAQ,../data/raw/BANCO CAIXA - 2022.xlsx
2022-05-24,PAG FONE LIGGA TELECOM - COPEL FIBRA - INTERNET,241437,0.0,148.18,"31.681,70",CAIXA,Despesas administrativas,"Telefonia (Celular, Fixo, Internet)",../data/raw/BANCO CAIXA - 2022.xlsx
2022-05-26,DP DIN LOT,261545,220.0,0.0,"31.901,70",CAIXA,Receita com serviços,Outras,../data/raw/BANCO CAIXA - 2022.xlsx
2022-05-30,PAG BOLETO VT LUIZ E ESTAGIARIOS LUCAS E JOÃO,301239,0.0,739.63,"31.162,07",CAIXA,Despesa com pessoal,Transporte (VT),../data/raw/BANCO CAIXA - 2022.xlsx
2022-06-01,PAG BOLETO FRESNOMAQ-WAP,11523,0.0,249.27,"30.912,80",CAIXA,Despesa com serviços,Fresnomaq,../data/raw/BANCO CAIXA - 2022.xlsx
2022-06-01,PAG BOLETO SPRINGER CARRIER,11528,0.0,133.9,"30.778,90",CAIXA,Despesa com serviços,Spring,../data/raw/BANCO CAIXA - 2022.xlsx
2022-06-01,PAG BOLETO SPRINGER CARRIER,11531,0.0,104.0,"30.674,90",CAIXA,Despesa com serviços,Spring,../data/raw/BANCO CAIXA - 2022.xlsx
2022-06-01,PAG BOLETO WHITE MARTINS,11534,0.0,30.9,"30.644,00",CAIXA,Despesa com produtos,Materiais de Consumo,../data/raw/BANCO CAIXA - 2022.xlsx
2022-06-01,PAG AGUA - CONTA DE ÁGUA,11536,0.0,155.6,"30.488,40",CAIXA,Despesas administrativas,Água,../data/raw/BANCO CAIXA - 2022.xlsx
2022-06-03,PAG BOLETO CIEE - ESTAGIÁRIOS,31617,0.0,875.75,"29.612,65",CAIXA,Despesa com pessoal,CIEE (Estagiario),../data/raw/BANCO CAIXA - 2022.xlsx
2022-06-06,SAQUE LOT P/ PAGTO DIVERSOS,61529,0.0,1230.0,"28.382,65",CAIXA,Despesas administrativas,Outras,../data/raw/BANCO CAIXA - 2022.xlsx
2022-06-06,DEB P FGTS,549570,0.0,1094.85,"27.287,80",CAIXA,Despesa com pessoal,FGTS,../data/raw/BANCO CAIXA - 2022.xlsx
2022-06-06,ENVIO TEV LUAN - PAGTO DE SALÁRIO,61114,0.0,936.18,"26.351,62",CAIXA,Despesa com pessoal,Salário,../data/raw/BANCO CAIXA - 2022.xlsx
2022-06-06,ENVIO TEV ROBSON - PAGTO DE SALÁRIO,61118,0.0,1428.42,"24.923,20",CAIXA,Despesa com pessoal,Salário,../data/raw/BANCO CAIXA - 2022.xlsx
2022-06-06,ENVIO PIX ELIZIA - PAGTO DE SALÁRIO,61123,0.0,1413.16,"23.510,04",CAIXA,Despesa com pessoal,Salário,../data/raw/BANCO CAIXA - 2022.xlsx
2022-06-06,ENVIO PIX RAMON - PAGTO DE SALÁRIO,61131,0.0,1009.92,"22.500,12",CAIXA,Despesa com pessoal,Salário,../data/raw/BANCO CAIXA - 2022.xlsx
2022-06-06,ENVIO PIX MATHEUS - PAGTO DE SALÁRIO,61134,0.0,1250.04,"21.250,08",CAIXA,Despesa com pessoal,Salário,../data/raw/BANCO CAIXA - 2022.xlsx
2022-06-06,ENVIO PIX ELISABETE - PAGTO PRÓ-LABORE,61142,0.0,1078.68,"20.171,40",CAIXA,Despesa com pessoal,Pró labore,../data/raw/BANCO CAIXA - 2022.xlsx
2022-06-06,DB CEST PJ,52022,0.0,69.0,"20.102,40",CAIXA,Despesas financeiras,Despesas bancárias,../data/raw/BANCO CAIXA - 2022.xlsx
2022-06-07,PG LUZ/GAS - ENERGIA LJ 3,886974,0.0,156.45,"19.945,95",CAIXA,Despesas administrativas,Energia,../data/raw/BANCO CAIXA - 2022.xlsx
2022-06-07,PG LUZ/GAS - ENERGIA LJ 4,887555,0.0,147.25,"19.798,70",CAIXA,Despesas administrativas,Energia,../data/raw/BANCO CAIXA - 2022.xlsx
2022-06-07,PAG BOLETO ALUGUEL,891499,0.0,4058.09,"15.740,61",CAIXA,Despesas administrativas,Aluguel imóvel,../data/raw/BANCO CAIXA - 2022.xlsx
2022-06-07,PG LUZ/GAS - ENERGIA LJ 6,891788,0.0,398.53,"15.342,08",CAIXA,Despesas administrativas,Energia,../data/raw/BANCO CAIXA - 2022.xlsx
2022-06-07,PAG BOLETO SPRINGER CARRIER,893215,0.0,475.75,"14.866,33",CAIXA,Despesa com serviços,Spring,../data/raw/BANCO CAIXA - 2022.xlsx
2022-06-07,ENVIO TEV CONTABILIDADE HONORÁRIOS,71956,0.0,491.5,"14.374,83",CAIXA,Despesas administrativas,Contabilidade,../data/raw/BANCO CAIXA - 2022.xlsx
2022-06-10,CRED TED PANASONIC DO BRASIL LIMITADA NFS-e 2168,341,4066.72,0.0,"18.441,55",CAIXA,Receita com serviços,Panasonic,../data/raw/BANCO CAIXA - 2022.xlsx
2022-06-13,CRED TED SPRINGER CARRIER LTDA NFS-e 2174,341,10330.0,0.0,"28.771,55",CAIXA,Receita com serviços,Spring,../data/raw/BANCO CAIXA - 2022.xlsx
2022-06-14,PAG BOLETO CARTÃO AMERICAN,142126,0.0,3452.98,"25.318,57",CAIXA,Despesas administrativas,Outras,../data/raw/BANCO CAIXA - 2022.xlsx
2022-06-15,ENVIO PIX MATHEUS- PAGTO RESCISÃO,150939,0.0,2579.44,"22.739,13",CAIXA,Despesa com pessoal,Aviso prévio / Multa rescisória,../data/raw/BANCO CAIXA - 2022.xlsx
2022-06-17,PG ORG GOV - DARF/GPS,171659,0.0,1352.88,"21.386,25",CAIXA,Despesas tributárias ,Outras,../data/raw/BANCO CAIXA - 2022.xlsx
2022-06-20,PG ORG GOV DARF - IRRF REF ALUGUEL IMÓVEL,190139,0.0,84.58,"21.301,67",CAIXA,Despesas tributárias ,Outras,../data/raw/BANCO CAIXA - 2022.xlsx
2022-06-20,ENVIO TEV LUAN - ADIANTAMENTO DE SALÁRIO,200631,0.0,720.0,"20.581,67",CAIXA,Despesa com pessoal,Salário,../data/raw/BANCO CAIXA - 2022.xlsx
2022-06-20,ENVIO TEV SIMONE,201512,0.0,1217.57,"19.364,10",CAIXA,Despesa com serviços,Outras,../data/raw/BANCO CAIXA - 2022.xlsx
2022-06-20,ENVIO TEV SIMONE,201516,0.0,5027.37,"14.336,73",CAIXA,Despesa com serviços,Outras,../data/raw/BANCO CAIXA - 2022.xlsx
2022-06-20,ENVIO TEV SIMONE,201519,0.0,1330.83,"13.005,90",CAIXA,Despesa com serviços,Outras,../data/raw/BANCO CAIXA - 2022.xlsx
2022-06-24,CRED TED SPRINGER CARRIER LTDA NFS-e 2178,341,1240.0,0.0,"14.245,90",CAIXA,Receita com serviços,Spring,../data/raw/BANCO CAIXA - 2022.xlsx
2022-07-01,ENVIO PIX PATRICK PAGAMENTO DE TERCEIRO,11703,0.0,570.0,"13.675,90",CAIXA,Despesa com serviços,Mão de obra,../data/raw/BANCO CAIXA - 2022.xlsx
2022-07-04,DP DIN LOT ANTONIO,41534,100.0,0.0,"13.775,90",CAIXA,Receita com serviços,Outras,../data/raw/BANCO CAIXA - 2022.xlsx
2022-07-05,ENVIO TEV HONORÁRIOS CONTABILIDADE,51118,0.0,491.5,"13.284,40",CAIXA,Despesas administrativas,Contabilidade,../data/raw/BANCO CAIXA - 2022.xlsx
2022-07-05,DB CEST PJ,62022,0.0,69.0,"13.215,40",CAIXA,Despesas financeiras,Despesas bancárias,../data/raw/BANCO CAIXA - 2022.xlsx
2022-07-06,ENVIO PIX ELIZIA - PAGTO DE SALÁRIO,61104,0.0,2136.41,"11.078,99",CAIXA,Despesa com pessoal,Salário,../data/raw/BANCO CAIXA - 2022.xlsx
2022-07-06,ENVIO PIX FERNANDA - PAGTO DE SALÁRIO,61109,0.0,1519.56,"9.559,43",CAIXA,Despesa com pessoal,Salário,../data/raw/BANCO CAIXA - 2022.xlsx
2022-07-06,ENVIO TEV LUAN - PAGTO DE SALÁRIO,61114,0.0,884.08,"8.675,35",CAIXA,Despesa com pessoal,Salário,../data/raw/BANCO CAIXA - 2022.xlsx
2022-07-06,ENVIO TEV ROBSON - PAGTO DE SALÁRIO,61117,0.0,1985.26,"6.690,09",CAIXA,Despesa com pessoal,Salário,../data/raw/BANCO CAIXA - 2022.xlsx
2022-07-06,ENVIO PIX ELISABETE- PAGTO PRÓ-LABORE,61129,0.0,1078.68,"5.611,41",CAIXA,Despesa com pessoal,Pró labore,../data/raw/BANCO CAIXA - 2022.xlsx
2022-07-06,PAG FGTS,61132,0.0,1194.49,"4.416,92",CAIXA,Despesa com pessoal,FGTS,../data/raw/BANCO CAIXA - 2022.xlsx
2022-07-08,CRED TED HORFRAN COM ELETRO MOVEIS NF-e 3777 E 3779,341,780.0,0.0,"5.196,92",CAIXA,Receita com serviços,Outras,../data/raw/BANCO CAIXA - 2022.xlsx
2022-07-08,ENVIO PIX EDRIC P/ PAGTO DE CONTAS ECEEL,81144,0.0,1500.0,"3.696,92",CAIXA,Despesas administrativas,Outras,../data/raw/BANCO CAIXA - 2022.xlsx
2022-07-11,CRED TED PANASONIC DO BRASIL LIMITADA NFS-e 2179,341,3572.55,0.0,"7.269,47",CAIXA,Receita com serviços,Panasonic,../data/raw/BANCO CAIXA - 2022.xlsx
2022-07-11,CRED TED FRESNOMAQ IND. DE MAQUINA NFS-e 2177,341,12225.4,0.0,"19.494,87",CAIXA,Receita com serviços,FRESNOMAQ,../data/raw/BANCO CAIXA - 2022.xlsx
2022-07-11,PAG BOLETO EMBALATEC-CAIXAS PAPELÃO,111718,0.0,4662.8,"14.832,07",CAIXA,Despesa com produtos,Materiais de Consumo,../data/raw/BANCO CAIXA - 2022.xlsx
2022-07-14,ENVIO PIX TATYANA - PAGTO DE FÉRIAS,141141,0.0,1482.29,"13.349,78",CAIXA,Despesa com pessoal,Salário,../data/raw/BANCO CAIXA - 2022.xlsx
2022-07-14,PAG BOLETO CARTÃO AMERICAN,141145,0.0,3383.94,"9.965,84",CAIXA,Despesas administrativas,Outras,../data/raw/BANCO CAIXA - 2022.xlsx
2022-07-15,CRED TED SPRINGER CARRIER LTDA NFS-e 2184,341,24023.23,0.0,"33.989,07",CAIXA,Receita com serviços,Spring,../data/raw/BANCO CAIXA - 2022.xlsx
2022-07-15,ENVIO PIX THIAGO PAGTO DE TERCEIROS,151618,0.0,1000.0,"32.989,07",CAIXA,Despesa com serviços,Mão de obra,../data/raw/BANCO CAIXA - 2022.xlsx
2022-07-18,CRED TED BRASANITAS HOSPITALAR HIGIEN NF-e 3804,237,1320.0,0.0,"34.309,07",CAIXA,Receita com serviços,Outras,../data/raw/BANCO CAIXA - 2022.xlsx
2022-07-20,PG ORG GOV DARF - IRRF REF ALUGUEL IMÓVEL,64268,0.0,84.58,"34.224,49",CAIXA,Despesas tributárias ,Outras,../data/raw/BANCO CAIXA - 2022.xlsx
2022-07-20,PG ORG GOV DARF/GPS,67420,0.0,1483.69,"32.740,80",CAIXA,Despesas tributárias ,Outras,../data/raw/BANCO CAIXA - 2022.xlsx
2022-07-20,PAG BOLETO CARTÃO INTER,274373,0.0,2102.56,"30.638,24",CAIXA,Despesas administrativas,Outras,../data/raw/BANCO CAIXA - 2022.xlsx
2022-07-20,PAG DARF-IRRF RAMON,436356,0.0,48.13,"30.590,11",CAIXA,Despesas tributárias ,Outras,../data/raw/BANCO CAIXA - 2022.xlsx
2022-07-20,PG ORG GOV DAS,457903,0.0,2999.29,"27.590,82",CAIXA,Despesas tributárias ,Outras,../data/raw/BANCO CAIXA - 2022.xlsx
2022-07-20,PAG FONE LIGGA TELECOM,469826,0.0,149.9,"27.440,92",CAIXA,Despesas administrativas,"Telefonia (Celular, Fixo, Internet)",../data/raw/BANCO CAIXA - 2022.xlsx
2022-07-20,PAG FONE NET FONE,481389,0.0,139.88,"27.301,04",CAIXA,Despesas administrativas,"Telefonia (Celular, Fixo, Internet)",../data/raw/BANCO CAIXA - 2022.xlsx
2022-07-20,PAG FONE CELULAR,482472,0.0,64.99,"27.236,05",CAIXA,Despesas administrativas,"Telefonia (Celular, Fixo, Internet)",../data/raw/BANCO CAIXA - 2022.xlsx
2022-07-20,ENVIO TEV LUAN - PAGTO ADIANTAMENTO QUINZENAL,201042,0.0,720.0,"26.516,05",CAIXA,Despesa com pessoal,Salário,../data/raw/BANCO CAIXA - 2022.xlsx
2022-07-20,ENVIO PIX RAMON - PAGTO ADIANTAMENTO QUINZENAL,201045,0.0,1080.0,"25.436,05",CAIXA,Despesa com pessoal,Salário,../data/raw/BANCO CAIXA - 2022.xlsx
2022-07-21,CRED TED FRESNOMAQ INDUSTRIA DE MAQUINA NFS-e 2183,341,6348.0,0.0,"31.784,05",CAIXA,Receita com serviços,FRESNOMAQ,../data/raw/BANCO CAIXA - 2022.xlsx
2022-07-21,ENVIO PIX PATRICK PAGAMENTO DE TERCEIRO,211520,0.0,410.0,"31.374,05",CAIXA,Despesa com serviços,Mão de obra,../data/raw/BANCO CAIXA - 2022.xlsx
2022-07-26,PAG BOLETO MED CURITIBA,261518,0.0,100.0,"31.274,05",CAIXA,Despesa com pessoal,Assistência médica,../data/raw/BANCO CAIXA - 2022.xlsx
2022-07-26,PAG BOLETO VT LUIZ E ESTAGIARIO LUCAS ,261522,0.0,552.63,"30.721,42",CAIXA,Despesa com pessoal,Transporte (VT),../data/raw/BANCO CAIXA - 2022.xlsx
2022-08-01,PAG BOLETO SELETROAR PARC. 01/03,157516,0.0,129.17,"30.592,25",CAIXA,Despesa com serviços,Peças,../data/raw/BANCO CAIXA - 2022.xlsx
2022-08-05,CRED TED BRASANITAS HOSPITALAR HIGIEN NFS-e 2186,237,350.0,0.0,"30.942,25",CAIXA,Receita com serviços,Outras,../data/raw/BANCO CAIXA - 2022.xlsx
2022-08-05,DEB P FGTS,516040,0.0,1216.18,"29.726,07",CAIXA,Despesa com pessoal,FGTS,../data/raw/BANCO CAIXA - 2022.xlsx
2022-08-05,PAG AGUA,590340,0.0,208.42,"29.517,65",CAIXA,Despesas administrativas,Água,../data/raw/BANCO CAIXA - 2022.xlsx
2022-08-05,ENVIO TEV LUAN - PAGTO DE SALÁRIO,51031,0.0,936.18,"28.581,47",CAIXA,Despesa com pessoal,Salário,../data/raw/BANCO CAIXA - 2022.xlsx
2022-08-05,ENVIO TEV ROBSON - PAGTO DE SALÁRIO,51035,0.0,1979.75,"26.601,72",CAIXA,Despesa com pessoal,Salário,../data/raw/BANCO CAIXA - 2022.xlsx
2022-08-05,ENVIO TEV CONTABILIDADE HONORÁRIOS,51037,0.0,491.5,"26.110,22",CAIXA,Despesas administrativas,Contabilidade,../data/raw/BANCO CAIXA - 2022.xlsx
2022-08-05,ENVIO PIX ELIZIA - PAGTO DE SALÁRIO,51057,0.0,1986.54,"24.123,68",CAIXA,Despesa com pessoal,Salário,../data/raw/BANCO CAIXA - 2022.xlsx
2022-08-05,ENVIO PIX FERNANDA - PAGTO DE SALÁRIO,51101,0.0,1596.69,"22.526,99",CAIXA,Despesa com pessoal,Salário,../data/raw/BANCO CAIXA - 2022.xlsx
2022-08-05,ENVIO PIX LUIZ - PAGTO DE SALÁRIO,51103,0.0,1375.34,"21.151,65",CAIXA,Despesa com pessoal,Salário,../data/raw/BANCO CAIXA - 2022.xlsx
2022-08-05,ENVIO TEV ALEXSANDRE - PAGTO DE SALÁRIO,51231,0.0,472.48,"20.679,17",CAIXA,Despesa com pessoal,Salário,../data/raw/BANCO CAIXA - 2022.xlsx
2022-08-05,DB CEST PJ,72022,0.0,69.0,"20.610,17",CAIXA,Despesas financeiras,Despesas bancárias,../data/raw/BANCO CAIXA - 2022.xlsx
2022-08-08,PAG BOLETO ALUGUEL,81645,0.0,4058.09,"16.552,08",CAIXA,Despesas administrativas,Aluguel imóvel,../data/raw/BANCO CAIXA - 2022.xlsx
2022-08-08,PAG BOLETO WHITE MARTINS,81647,0.0,30.9,"16.521,18",CAIXA,Despesa com produtos,Materiais de Consumo,../data/raw/BANCO CAIXA - 2022.xlsx
2022-08-08,PAG BOLETO MASTER FILME 1/3 PARC.,81651,0.0,457.0,"16.064,18",CAIXA,Despesa com produtos,Materiais de Consumo,../data/raw/BANCO CAIXA - 2022.xlsx
2022-08-09,PAG BOLETO CIEE - ESTAGIÁRIO,91638,0.0,316.36,"15.747,82",CAIXA,Despesa com pessoal,CIEE (Estagiario),../data/raw/BANCO CAIXA - 2022.xlsx
2022-08-10,CRED TED PANASONIC DO BRASIL LIMITADA NFS-e 2190,341,3898.58,0.0,"19.646,40",CAIXA,Receita com serviços,Panasonic,../data/raw/BANCO CAIXA - 2022.xlsx
2022-08-11,CRED TED SPRINGER CARRIER LTDA NFS-e 2197,341,15987.82,0.0,"35.634,22",CAIXA,Receita com serviços,Spring,../data/raw/BANCO CAIXA - 2022.xlsx
2022-08-12,CRED PIX JULIO PEDRO VAZ ESMERALDO,120944,110.0,0.0,"35.744,22",CAIXA,Receita com serviços,Outras,../data/raw/BANCO CAIXA - 2022.xlsx
2022-08-12,PAG BOLETO CARTÃO AMERICAN,121649,0.0,1247.59,"34.496,63",CAIXA,Despesas administrativas,Outras,../data/raw/BANCO CAIXA - 2022.xlsx
2022-08-12,PG LUZ/GAS - ENERGIA LJ 03,121652,0.0,100.1,"34.396,53",CAIXA,Despesas administrativas,Energia,../data/raw/BANCO CAIXA - 2022.xlsx
2022-08-12,PG LUZ/GAS - ENERGIA LJ 04,121654,0.0,120.92,"34.275,61",CAIXA,Despesas administrativas,Energia,../data/raw/BANCO CAIXA - 2022.xlsx
2022-08-12,PG LUZ/GAS - ENERGIA LJ 06,121659,0.0,375.65,"33.899,96",CAIXA,Despesas administrativas,Energia,../data/raw/BANCO CAIXA - 2022.xlsx
2022-08-12,PAG DARF- IRRF RAMON,121704,0.0,55.68,"33.844,28",CAIXA,Despesas tributárias ,Outras,../data/raw/BANCO CAIXA - 2022.xlsx
2022-08-12,PG ORG GOV DARF/GPS,121708,0.0,1514.19,"32.330,09",CAIXA,Despesas tributárias ,Outras,../data/raw/BANCO CAIXA - 2022.xlsx
2022-08-12,PG ORG GOV DARF - IRRF REF ALUGUEL IMÓVEL,121723,0.0,84.58,"32.245,51",CAIXA,Despesas tributárias ,Outras,../data/raw/BANCO CAIXA - 2022.xlsx
2022-08-16,ENVIO PIX THIAGO PAGTO DE TERCEIROS,161457,0.0,1000.0,"31.245,51",CAIXA,Despesa com serviços,Mão de obra,../data/raw/BANCO CAIXA - 2022.xlsx
2022-08-19,DP DIN LOT GAZIN IND. E COM. DE MÓVEIS E ELETROD.,191708,60.0,0.0,"31.305,51",CAIXA,Receita com serviços,Outras,../data/raw/BANCO CAIXA - 2022.xlsx
2022-08-19,DP DIN LOT GAZIN IND. E COM. DE MÓVEIS E ELETROD.,191709,78.0,0.0,"31.383,51",CAIXA,Receita com serviços,Outras,../data/raw/BANCO CAIXA - 2022.xlsx
2022-08-19,PAG BOLETO  MASTER FILME - 2/3 PARC,206670,0.0,457.0,"30.926,51",CAIXA,Despesa com produtos,Materiais de Consumo,../data/raw/BANCO CAIXA - 2022.xlsx
2022-08-19,PG ORG GOV DAS,516253,0.0,3580.57,"27.345,94",CAIXA,Despesas tributárias ,Outras,../data/raw/BANCO CAIXA - 2022.xlsx
2022-08-19,PAG FONE LIGGA TELECOM,535863,0.0,149.9,"27.196,04",CAIXA,Despesas administrativas,"Telefonia (Celular, Fixo, Internet)",../data/raw/BANCO CAIXA - 2022.xlsx
2022-08-19,PAG FONE - CELULAR,536856,0.0,64.99,"27.131,05",CAIXA,Despesas administrativas,"Telefonia (Celular, Fixo, Internet)",../data/raw/BANCO CAIXA - 2022.xlsx
2022-08-19,ENVIO TEV LUAN - PAGTO ADIANTAMENTO QUINZENAL,191026,0.0,650.32,"26.480,73",CAIXA,Despesa com pessoal,Salário,../data/raw/BANCO CAIXA - 2022.xlsx
2022-08-19,ENVIO PIX RAMON - PAGTO ADIANTAMENTO QUINZENAL,191029,0.0,1080.0,"25.400,73",CAIXA,Despesa com pessoal,Salário,../data/raw/BANCO CAIXA - 2022.xlsx
2022-08-19,ENVIO PIX ELIZIA - PAGTO RESCISÃO DE CONTRATO,191036,0.0,108.64,"25.292,09",CAIXA,Despesa com pessoal,Aviso prévio / Multa rescisória,../data/raw/BANCO CAIXA - 2022.xlsx
2022-08-19,ENVIO TEV KENY - PAGTO TERCEIRO,191232,0.0,100.0,"25.192,09",CAIXA,Despesa com serviços,Mão de obra,../data/raw/BANCO CAIXA - 2022.xlsx
2022-08-19,ENVIO TEV ADAM - PAGTO TERCEIRO,191414,0.0,100.0,"25.092,09",CAIXA,Despesa com serviços,Mão de obra,../data/raw/BANCO CAIXA - 2022.xlsx
2022-08-22,CRED TED FRESNOMAQ INDUSTRIA DE MAQUINA NFS-e 2193,341,2161.0,0.0,"27.253,09",CAIXA,Receita com serviços,FRESNOMAQ,../data/raw/BANCO CAIXA - 2022.xlsx
2022-08-22,PAG FONE CLARO-NET FONE,15431,0.0,125.72,"27.127,37",CAIXA,Despesas administrativas,"Telefonia (Celular, Fixo, Internet)",../data/raw/BANCO CAIXA - 2022.xlsx
2022-08-22,PAG BOLETO PACKPAR EMBALAGENS,515635,0.0,79.0,"27.048,37",CAIXA,Despesa com produtos,Materiais de Consumo,../data/raw/BANCO CAIXA - 2022.xlsx
2022-08-22,PAG BOLETO FRESNOMAQ/WAP 1/2,519718,0.0,338.11,"26.710,26",CAIXA,Despesa com serviços,Fresnomaq,../data/raw/BANCO CAIXA - 2022.xlsx
2022-08-25,CRED TED JULIO PEDRO VAZ ESMERALDO,33,35.0,0.0,"26.745,26",CAIXA,Receita com serviços,Outras,../data/raw/BANCO CAIXA - 2022.xlsx
2022-08-25,PAG BOLETO MED CURITIBA,387969,0.0,273.0,"26.472,26",CAIXA,Despesa com pessoal,Assistência médica,../data/raw/BANCO CAIXA - 2022.xlsx
2022-08-25,ENVIO TEV LUAN - PAGTO DE FÉRIAS,251528,0.0,1426.25,"25.046,01",CAIXA,Despesa com pessoal,Salário,../data/raw/BANCO CAIXA - 2022.xlsx
2022-08-25,ENVIO PIX LAURA - PAGTO DE TERCEIROS,251550,0.0,600.0,"24.446,01",CAIXA,Despesa com serviços,Mão de obra,../data/raw/BANCO CAIXA - 2022.xlsx
2022-08-26,CRED TED HORFRAN COM ELETRO MOVEIS NF-e 3846,341,400.0,0.0,"24.846,01",CAIXA,Receita com serviços,Outras,../data/raw/BANCO CAIXA - 2022.xlsx
2022-08-30,PAG BOLETO VT LUIZ E ESTAGIARIO LUCAS ,302018,0.0,486.94,"24.359,07",CAIXA,Despesa com pessoal,Transporte (VT),../data/raw/BANCO CAIXA - 2022.xlsx
2022-08-31,ENVIO PIX GUILHERME - PAGTO VALE TRANSPORTE ESTAGIÁRIO,312025,0.0,220.0,"24.139,07",CAIXA,Despesa com pessoal,Transporte (VT),../data/raw/BANCO CAIXA - 2022.xlsx
2022-09-02,CRED TED BRASANITAS HOSP HIGIEN - NFS-e 2196 E NF-e 3845,237,630.0,0.0,"24.769,07",CAIXA,Receita com serviços,Outras,../data/raw/BANCO CAIXA - 2022.xlsx
2022-09-05,PAG AGUA,51456,0.0,246.82,"24.522,25",CAIXA,Despesas administrativas,Água,../data/raw/BANCO CAIXA - 2022.xlsx
2022-09-05,ENVIO TEV CONTABILIDADE HONORÁRIOS,51458,0.0,491.5,"24.030,75",CAIXA,Despesas administrativas,Contabilidade,../data/raw/BANCO CAIXA - 2022.xlsx
2022-09-05,DB CEST PJ,82022,0.0,69.0,"23.961,75",CAIXA,Despesas financeiras,Despesas bancárias,../data/raw/BANCO CAIXA - 2022.xlsx
2022-09-06,SAQUE LOT P/ PAGTOS DIVERSOS,61510,0.0,500.0,"23.461,75",CAIXA,Despesas administrativas,Outras,../data/raw/BANCO CAIXA - 2022.xlsx
2022-09-06,PAG BOLETO PAG BOLETO ALUGUEL,403256,0.0,4058.09,"19.403,66",CAIXA,Despesas administrativas,Aluguel imóvel,../data/raw/BANCO CAIXA - 2022.xlsx
2022-09-06,PAG BOLETO MASTER FILME - 3/3 PARC,406723,0.0,457.0,"18.946,66",CAIXA,Despesa com produtos,Materiais de Consumo,../data/raw/BANCO CAIXA - 2022.xlsx
2022-09-06,PAG BOLETO CIEE - ESTAGIÁRIOS,411044,0.0,617.72,"18.328,94",CAIXA,Despesa com pessoal,CIEE (Estagiario),../data/raw/BANCO CAIXA - 2022.xlsx
2022-09-06,PAG DARF - IRRF RAMON,464190,0.0,61.11,"18.267,83",CAIXA,Despesas tributárias ,Outras,../data/raw/BANCO CAIXA - 2022.xlsx
2022-09-06,DEB P FGTS,561965,0.0,1290.92,"16.976,91",CAIXA,Despesa com pessoal,FGTS,../data/raw/BANCO CAIXA - 2022.xlsx
2022-09-06,ENVIO TEV ALEXSANDRE - PAGTO DE SALÁRIO,61124,0.0,1519.55,"15.457,36",CAIXA,Despesa com pessoal,Salário,../data/raw/BANCO CAIXA - 2022.xlsx
2022-09-06,ENVIO TEV LUAN - PAGTO DE SALÁRIO,61126,0.0,834.89,"14.622,47",CAIXA,Despesa com pessoal,Salário,../data/raw/BANCO CAIXA - 2022.xlsx
2022-09-06,ENVIO TEV ROBSON - PAGTO DE SALÁRIO,61128,0.0,1929.91,"12.692,56",CAIXA,Despesa com pessoal,Salário,../data/raw/BANCO CAIXA - 2022.xlsx
2022-09-06,ENVIO PIX FERNANDA - PAGTO DE SALÁRIO,61142,0.0,1583.95,"11.108,61",CAIXA,Despesa com pessoal,Salário,../data/raw/BANCO CAIXA - 2022.xlsx
2022-09-06,ENVIO PIX LUIZ - PAGTO DE SALÁRIO,61145,0.0,1180.73,"9.927,88",CAIXA,Despesa com pessoal,Salário,../data/raw/BANCO CAIXA - 2022.xlsx
2022-09-06,ENVIO PIX THIAGO - PAGTO DE SALÁRIO,61148,0.0,836.9,"9.090,98",CAIXA,Despesa com pessoal,Salário,../data/raw/BANCO CAIXA - 2022.xlsx
2022-09-06,ENVIO PIX ELISABETE - PAGTO PRÓ-LABORE,61150,0.0,1078.68,"8.012,30",CAIXA,Despesa com pessoal,Pró labore,../data/raw/BANCO CAIXA - 2022.xlsx
2022-09-12,CRED TED PANASONIC DO BRASIL LIMITADA NFS-e 2200,341,3989.13,0.0,"12.001,43",CAIXA,Receita com serviços,Panasonic,../data/raw/BANCO CAIXA - 2022.xlsx
2022-09-13,CRED TED ELGIN S A,237,43.0,0.0,"12.044,43",CAIXA,Receita com serviços,Elgin,../data/raw/BANCO CAIXA - 2022.xlsx
2022-09-13,CRED TED SPRINGER CARRIER LTDA NFS-e 2211,341,9327.46,0.0,"21.371,89",CAIXA,Receita com serviços,Spring,../data/raw/BANCO CAIXA - 2022.xlsx
2022-09-13,CRED TED SPRINGER CARRIER LTDA NFS-e 2210,341,4545.0,0.0,"25.916,89",CAIXA,Receita com serviços,Spring,../data/raw/BANCO CAIXA - 2022.xlsx
2022-09-14,PAG BOLETO WHITE MARTINS,243593,0.0,112.49,"25.804,40",CAIXA,Despesa com produtos,Materiais de Consumo,../data/raw/BANCO CAIXA - 2022.xlsx
2022-09-14,PG LUZ/GAS ENERGIA LJ 3,549688,0.0,117.78,"25.686,62",CAIXA,Despesas administrativas,Energia,../data/raw/BANCO CAIXA - 2022.xlsx
2022-09-14,PG LUZ/GAS ENERGIA LJ 4,550168,0.0,135.55,"25.551,07",CAIXA,Despesas administrativas,Energia,../data/raw/BANCO CAIXA - 2022.xlsx
2022-09-14,PG LUZ/GAS ENERGIA LJ 6,550703,0.0,424.44,"25.126,63",CAIXA,Despesas administrativas,Energia,../data/raw/BANCO CAIXA - 2022.xlsx
2022-09-15,PAG BOLETO CARTÃO AMERICAN,243598,0.0,5081.32,"20.045,31",CAIXA,Despesas administrativas,Outras,../data/raw/BANCO CAIXA - 2022.xlsx
2022-09-15,PAG BOLETO CIEE - RESCISÃO  ESTAGIÁRIOS,249358,0.0,181.36,"19.863,95",CAIXA,Despesa com pessoal,Aviso prévio / Multa rescisória,../data/raw/BANCO CAIXA - 2022.xlsx
2022-09-15,ENVIO PIX RAMON - PAGTO RESCISÃO,151142,0.0,4037.96,"15.825,99",CAIXA,Despesa com pessoal,Aviso prévio / Multa rescisória,../data/raw/BANCO CAIXA - 2022.xlsx
2022-09-19,PG ORG GOV DARF - IRRF REF ALUGUEL IMÓVEL,143397,0.0,84.58,"15.741,41",CAIXA,Despesas tributárias ,Outras,../data/raw/BANCO CAIXA - 2022.xlsx
2022-09-19,PAG BOLETO CARTÃO INTER,949614,0.0,2811.27,"12.930,14",CAIXA,Despesas administrativas,Outras,../data/raw/BANCO CAIXA - 2022.xlsx
2022-09-19,PAG BOLETO FRESNOMAQ-WAP 2/2 PARC.,951946,0.0,338.1,"12.592,04",CAIXA,Despesa com serviços,Fresnomaq,../data/raw/BANCO CAIXA - 2022.xlsx
2022-09-19,PG ORG GOV DAS,970950,0.0,2772.71,"9.819,33",CAIXA,Despesas tributárias ,Outras,../data/raw/BANCO CAIXA - 2022.xlsx
2022-09-19,PAG FONE - NET FONE,972947,0.0,123.6,"9.695,73",CAIXA,Despesas administrativas,"Telefonia (Celular, Fixo, Internet)",../data/raw/BANCO CAIXA - 2022.xlsx
2022-09-19,PAG FONE - CELULAR,973369,0.0,51.62,"9.644,11",CAIXA,Despesas administrativas,"Telefonia (Celular, Fixo, Internet)",../data/raw/BANCO CAIXA - 2022.xlsx
2022-09-19,PAG FONE - LIGGA TELECOM-INTERNET,973785,0.0,149.9,"9.494,21",CAIXA,Despesas administrativas,"Telefonia (Celular, Fixo, Internet)",../data/raw/BANCO CAIXA - 2022.xlsx
2022-09-19,ENVIO TEV LUAN - PAGTO ADIANTAMENTO QUINZENAL,192016,0.0,336.0,"9.158,21",CAIXA,Despesa com pessoal,Salário,../data/raw/BANCO CAIXA - 2022.xlsx
2022-09-20,PAG BOLETO MED CURITIBA,201212,0.0,130.0,"9.028,21",CAIXA,Despesa com pessoal,Assistência médica,../data/raw/BANCO CAIXA - 2022.xlsx
2022-09-21,CRED TED GREE ELECTRIC APPLIANCES DO BR - NFS-e 2212,237,73.3,0.0,"9.101,51",CAIXA,Receita com serviços,Outras,../data/raw/BANCO CAIXA - 2022.xlsx
2022-09-21,CRED TED FRESNOMAQ INDUSTRIA DE MAQUINA - NFS-e 2209,341,1861.0,0.0,"10.962,51",CAIXA,Receita com serviços,FRESNOMAQ,../data/raw/BANCO CAIXA - 2022.xlsx
2022-09-27,PAG BOLETO - VT LUCAS ESTAGIÁRIO,271254,0.0,277.94,"10.684,57",CAIXA,Despesa com pessoal,Transporte (VT),../data/raw/BANCO CAIXA - 2022.xlsx
2022-09-27,ENVIO PIX LAURA - PAGTO DE TERCEIROS,271301,0.0,360.0,"10.324,57",CAIXA,Despesa com serviços,Mão de obra,../data/raw/BANCO CAIXA - 2022.xlsx
2022-10-03,PAG BOLETO SELETROAR PARC. 02/03,31607,0.0,129.17,"10.195,40",CAIXA,Despesa com serviços,Peças,../data/raw/BANCO CAIXA - 2022.xlsx
2022-10-03,PAG AGUA,31613,0.0,162.28,"10.033,12",CAIXA,Despesas administrativas,Água,../data/raw/BANCO CAIXA - 2022.xlsx
2022-10-05,CREDITO TED - PAGSEGURO INTERNET LTDA,290,1319.04,0.0,"11.352,16",CAIXA,Receita com serviços,Outras,../data/raw/BANCO CAIXA - 2022.xlsx
2022-10-05,SAQUE LOT P/ PAGTOS DIVERSOS,51805,0.0,1500.0,"9.852,16",CAIXA,Despesas administrativas,Outras,../data/raw/BANCO CAIXA - 2022.xlsx
2022-10-05,ENVIO TEV CONTABILIDADE HONORÁRIOS,51149,0.0,491.5,"9.360,66",CAIXA,Despesas administrativas,Contabilidade,../data/raw/BANCO CAIXA - 2022.xlsx
2022-10-05,ENVIO PIX ELIZEU - PAGTO CONSERTO DA PORTA DE AÇO ECEEL,51755,0.0,350.0,"9.010,66",CAIXA,Despesas administrativas,Manutenção predial,../data/raw/BANCO CAIXA - 2022.xlsx
2022-10-05,DB CEST PJ,92022,0.0,69.0,"8.941,66",CAIXA,Despesas financeiras,Despesas bancárias,../data/raw/BANCO CAIXA - 2022.xlsx
2022-10-06,CRED TED P H XAVIER ADVOGADOS NFS-e 2208,341,420.0,0.0,"9.361,66",CAIXA,Receita com serviços,Outras,../data/raw/BANCO CAIXA - 2022.xlsx
2022-10-06,ENVIO TEV ALEXSANDRE - PAGTO DE SALÁRIO,61118,0.0,1546.41,"7.815,25",CAIXA,Despesa com pessoal,Salário,../data/raw/BANCO CAIXA - 2022.xlsx
2022-10-06,ENVIO TEV LUAN - PAGTO DE SALÁRIO,61120,0.0,431.73,"7.383,52",CAIXA,Despesa com pessoal,Salário,../data/raw/BANCO CAIXA - 2022.xlsx
2022-10-06,ENVIO TEV ROBSON - PAGTO DE SALÁRIO,61121,0.0,1838.18,"5.545,34",CAIXA,Despesa com pessoal,Salário,../data/raw/BANCO CAIXA - 2022.xlsx
2022-10-06,ENVIO PIX FERNANDA  - PAGTO DE SALÁRIO,61126,0.0,1519.56,"4.025,78",CAIXA,Despesa com pessoal,Salário,../data/raw/BANCO CAIXA - 2022.xlsx
2022-10-06,ENVIO PIX THIAGO  - PAGTO DE SALÁRIO,61133,0.0,1519.55,"2.506,23",CAIXA,Despesa com pessoal,Salário,../data/raw/BANCO CAIXA - 2022.xlsx
2022-10-06,ENVIO PIX LAURA  - PAGTO DE SALÁRIO,61137,0.0,588.91,"1.917,32",CAIXA,Despesa com pessoal,Salário,../data/raw/BANCO CAIXA - 2022.xlsx
2022-10-06,ENVIO PIX ELISABETE - PAGTO PRÓ-LABORE,61141,0.0,1078.68,"838,64",CAIXA,Despesa com pessoal,Pró labore,../data/raw/BANCO CAIXA - 2022.xlsx
2022-10-10,CRED TED PANASONIC DO BRASIL LIMITADA NFS-e 2216,341,4490.46,0.0,"5.329,10",CAIXA,Receita com serviços,Panasonic,../data/raw/BANCO CAIXA - 2022.xlsx
2022-10-14,   CRED TED ELGIN S A,237,43.0,0.0,"5.372,10",CAIXA,Receita com serviços,Elgin,../data/raw/BANCO CAIXA - 2022.xlsx
2022-10-14,PAG BOLETO CARTÃO AMERICAN,141949,0.0,477.75,"4.894,35",CAIXA,Despesas administrativas,Outras,../data/raw/BANCO CAIXA - 2022.xlsx
2022-10-14,PG LUZ/GAS ENERGIA LJ 03,141951,0.0,103.84,"4.790,51",CAIXA,Despesas administrativas,Energia,../data/raw/BANCO CAIXA - 2022.xlsx
2022-10-14,PG LUZ/GAS ENERGIA LJ 04,141953,0.0,95.09,"4.695,42",CAIXA,Despesas administrativas,Energia,../data/raw/BANCO CAIXA - 2022.xlsx
2022-10-14,PG LUZ/GAS ENERGIA LJ 06,141954,0.0,397.22,"4.298,20",CAIXA,Despesas administrativas,Energia,../data/raw/BANCO CAIXA - 2022.xlsx
2022-10-14,PAG BOLETO WHITE MARTINS,141956,0.0,30.9,"4.267,30",CAIXA,Despesa com produtos,Materiais de Consumo,../data/raw/BANCO CAIXA - 2022.xlsx
2022-10-17,CRED TED SPRINGER CARRIER LTDA NFS-e 2221,341,10487.1,0.0,"14.754,40",CAIXA,Receita com serviços,Spring,../data/raw/BANCO CAIXA - 2022.xlsx
2022-10-17,CRED PIX HORFRAN COM ELETRO MOVEIS LTDA NF-e 3875,171604,515.0,0.0,"15.269,40",CAIXA,Receita com serviços,Outras,../data/raw/BANCO CAIXA - 2022.xlsx
2022-10-19,PG ORG GOV DARF/GPS,191807,0.0,1576.75,"13.692,65",CAIXA,Despesas tributárias ,Outras,../data/raw/BANCO CAIXA - 2022.xlsx
2022-10-19,PG ORG GOV DARF - IRRF REF ALUGUEL IMÓVEL,191809,0.0,84.58,"13.608,07",CAIXA,Despesas tributárias ,Outras,../data/raw/BANCO CAIXA - 2022.xlsx
2022-10-19,PG ORG GOV DAS,191812,0.0,2138.35,"11.469,72",CAIXA,Despesas tributárias ,Outras,../data/raw/BANCO CAIXA - 2022.xlsx
2022-10-20,CRED PIX HORFRAN COM ELETRO MOVEIS LTDA NF-e 3915,201609,15.0,0.0,"11.484,72",CAIXA,Receita com serviços,Outras,../data/raw/BANCO CAIXA - 2022.xlsx
2022-10-20,ENVIO TEV LUAN - PAGTO ADIANTAMENTO QUINZENAL,201116,0.0,720.0,"10.764,72",CAIXA,Despesa com pessoal,Salário,../data/raw/BANCO CAIXA - 2022.xlsx
2022-10-21,CRED TED FRESNOMAQ INDUSTRIA DE MAQUINA NFS-e 2219,341,2636.0,0.0,"13.400,72",CAIXA,Receita com serviços,FRESNOMAQ,../data/raw/BANCO CAIXA - 2022.xlsx
2022-10-21,PAG FGTS - RESCISÃO DO ALEXSANDRE,211542,0.0,81.56,"13.319,16",CAIXA,Despesa com pessoal,FGTS,../data/raw/BANCO CAIXA - 2022.xlsx
2022-10-21,ENVIO TED SPRINGER CARRIER PAGTO REF. A NF 725538 1/3 PARC.,211556,0.0,424.25,"12.894,91",CAIXA,Despesa com serviços,Spring,../data/raw/BANCO CAIXA - 2022.xlsx
2022-10-24,DP DIN LOT - CLIENTE,241650,120.0,0.0,"13.014,91",CAIXA,Receita com serviços,Outras,../data/raw/BANCO CAIXA - 2022.xlsx
2022-10-25,CRED TED LOJAS COLOMBO S A COM UTIL DOM - NF-e 3916,422,30.0,0.0,"13.044,91",CAIXA,Receita com serviços,Outras,../data/raw/BANCO CAIXA - 2022.xlsx
2022-11-03,CRED TED SPRINGER CARRIER LTDA NFS-e 2224,341,12932.04,0.0,"24.654,05",CAIXA,Receita com serviços,Spring,../data/raw/BANCO CAIXA - 2022.xlsx
2022-11-03,CRED PIX HORFRAN COM ELETRO MOVEIS LTDA NFS-e 2204,31611,120.0,0.0,"24.774,05",CAIXA,Receita com serviços,Outras,../data/raw/BANCO CAIXA - 2022.xlsx
2022-11-04,ENVIO TEV HONORÁRIOS CONTABILIDADE,41532,0.0,491.5,"24.282,55",CAIXA,Despesas administrativas,Contabilidade,../data/raw/BANCO CAIXA - 2022.xlsx
2022-11-07,ENVIO PIX ELISABETE - PAGTO PRO-LABORE,62144,0.0,1078.68,"23.203,87",CAIXA,Despesa com pessoal,Pró labore,../data/raw/BANCO CAIXA - 2022.xlsx
2022-11-07,ENVIO PIX CLAUDIO - PAGTO PRO-LABORE,62149,0.0,1078.68,"22.125,19",CAIXA,Despesa com pessoal,Pró labore,../data/raw/BANCO CAIXA - 2022.xlsx
2022-11-07,ENVIO TEV LUAN - PAGTO DE SALÁRIO,71106,0.0,1076.31,"21.048,88",CAIXA,Despesa com pessoal,Salário,../data/raw/BANCO CAIXA - 2022.xlsx
2022-11-07,ENVIO TEV ROBSON - PAGTO DE SALÁRIO,71109,0.0,2043.79,"19.005,09",CAIXA,Despesa com pessoal,Salário,../data/raw/BANCO CAIXA - 2022.xlsx
2022-11-07,ENVIO PIX FERNANDA - PAGRO DE SALÁRIO,71115,0.0,1504.6,"17.500,49",CAIXA,Despesa com pessoal,Salário,../data/raw/BANCO CAIXA - 2022.xlsx
2022-11-07,ENVIO PIX TATYANA - PAGRO DE SALÁRIO,71122,0.0,1838.81,"15.661,68",CAIXA,Despesa com pessoal,Salário,../data/raw/BANCO CAIXA - 2022.xlsx
2022-11-07,ENVIO PIX THIAGO - PAGRO DE SALÁRIO,71126,0.0,1521.2,"14.140,48",CAIXA,Despesa com pessoal,Salário,../data/raw/BANCO CAIXA - 2022.xlsx
2022-11-07,DB CEST PJ,102022,0.0,69.0,"14.071,48",CAIXA,Despesas financeiras,Despesas bancárias,../data/raw/BANCO CAIXA - 2022.xlsx
2022-11-10,CRED TED PANASONIC DO BRASIL LIMITADA NFS-e 2225,341,2907.15,0.0,"16.978,63",CAIXA,Receita com serviços,Panasonic,../data/raw/BANCO CAIXA - 2022.xlsx
2022-11-11,ENVIO PIX FERNANDA - PAGTO RESCISÃO,110952,0.0,1561.52,"15.417,11",CAIXA,Despesa com pessoal,Aviso prévio / Multa rescisória,../data/raw/BANCO CAIXA - 2022.xlsx
2022-11-11,PAG DARF-IRRF - ROBSON,111000,0.0,11.33,"15.405,78",CAIXA,Despesas tributárias ,Outras,../data/raw/BANCO CAIXA - 2022.xlsx
2022-11-14,PG ORG GOV DARF - IRRF REF ALUGUEL IMÓVEL,141716,0.0,84.58,"15.321,20",CAIXA,Despesas tributárias ,Outras,../data/raw/BANCO CAIXA - 2022.xlsx
2022-11-14,PG ORG GOV - DARF/GPS,141718,0.0,1191.85,"14.129,35",CAIXA,Despesas tributárias ,Outras,../data/raw/BANCO CAIXA - 2022.xlsx
2022-11-16,CRED TED SPRINGER CARRIER LTDA NFS-e 2230,341,10868.33,0.0,"24.997,68",CAIXA,Receita com serviços,Spring,../data/raw/BANCO CAIXA - 2022.xlsx
2022-11-18,ENVIO TEV LUAN -  PAGTO ADIANTAMENTO QUINZENAL,181459,0.0,720.0,"24.277,68",CAIXA,Despesa com pessoal,Salário,../data/raw/BANCO CAIXA - 2022.xlsx
2022-11-18,PAG BOLETO VR BENEFÍCIOS,181503,0.0,306.0,"23.971,68",CAIXA,Despesa com pessoal,Alimentação (VR VA),../data/raw/BANCO CAIXA - 2022.xlsx
2022-11-18,PAG BOLETO CARTÃO INTER,181506,0.0,3075.99,"20.895,69",CAIXA,Despesas administrativas,Outras,../data/raw/BANCO CAIXA - 2022.xlsx
2022-11-18,PG ORG GOV DAS,181515,0.0,2878.46,"18.017,23",CAIXA,Despesas tributárias ,Outras,../data/raw/BANCO CAIXA - 2022.xlsx
2022-11-21,CRED TED FRESNOMAQ INDUSTRIA DE MAQUINA NFS-e 2229,341,6057.52,0.0,"24.074,75",CAIXA,Receita com serviços,FRESNOMAQ,../data/raw/BANCO CAIXA - 2022.xlsx
2022-11-22,PAG BOLETO MED CURITIBA,190325,0.0,108.0,"23.966,75",CAIXA,Despesa com pessoal,Assistência médica,../data/raw/BANCO CAIXA - 2022.xlsx
2022-11-22,PAG BOLETO MASTER FILME 2/3 PARCELAS,197416,0.0,514.5,"23.452,25",CAIXA,Despesa com produtos,Materiais de Consumo,../data/raw/BANCO CAIXA - 2022.xlsx
2022-11-22,PAG FONE CELULAR,487837,0.0,57.61,"23.394,64",CAIXA,Despesas administrativas,"Telefonia (Celular, Fixo, Internet)",../data/raw/BANCO CAIXA - 2022.xlsx
2022-11-22,PAG FONE NET FONE,488287,0.0,126.31,"23.268,33",CAIXA,Despesas administrativas,"Telefonia (Celular, Fixo, Internet)",../data/raw/BANCO CAIXA - 2022.xlsx
2022-11-22,PAG FONE LIGGA TELECOM,488752,0.0,149.9,"23.118,43",CAIXA,Despesas administrativas,"Telefonia (Celular, Fixo, Internet)",../data/raw/BANCO CAIXA - 2022.xlsx
2022-11-28,PAG BOLETO VT ESTAGIÁRIOS,845445,0.0,662.94,"22.455,49",CAIXA,Despesa com pessoal,Transporte (VT),../data/raw/BANCO CAIXA - 2022.xlsx
2022-11-29,PAG BOLETO VR BENEFÍCIOS,432546,0.0,1300.0,"21.155,49",CAIXA,Despesa com pessoal,Alimentação (VR VA),../data/raw/BANCO CAIXA - 2022.xlsx
2022-11-29,ENVIO PIX LAURA - ADIANT. 13º SALÁRIO,291634,0.0,187.25,"20.968,24",CAIXA,Despesa com pessoal,13º salário,../data/raw/BANCO CAIXA - 2022.xlsx
2022-11-29,ENVIO TEV LUAN - ADIANT. 13º SALÁRIO,291637,0.0,675.0,"20.293,24",CAIXA,Despesa com pessoal,13º salário,../data/raw/BANCO CAIXA - 2022.xlsx
2022-11-29,ENVIO TEV ROBSON - ADIANT. 13º SALÁRIO,291639,0.0,666.66,"19.626,58",CAIXA,Despesa com pessoal,13º salário,../data/raw/BANCO CAIXA - 2022.xlsx
2022-11-29,ENVIO PIX TATYANA - ADIANT. 13º SALÁRIO,291644,0.0,907.45,"18.719,13",CAIXA,Despesa com pessoal,13º salário,../data/raw/BANCO CAIXA - 2022.xlsx
2022-11-29,ENVIO PIX THIAGO - ADIANT. 13º SALÁRIO,291647,0.0,343.71,"18.375,42",CAIXA,Despesa com pessoal,13º salário,../data/raw/BANCO CAIXA - 2022.xlsx
2022-11-29,ENVIO TEV MARINA - ADIANT. 13º SALÁRIO,291709,0.0,150.0,"18.225,42",CAIXA,Despesa com pessoal,13º salário,../data/raw/BANCO CAIXA - 2022.xlsx
2022-11-29,ENVIO PIX OSIEL - ADIANT. 13º SALÁRIO,291804,0.0,208.33,"18.017,09",CAIXA,Despesa com pessoal,13º salário,../data/raw/BANCO CAIXA - 2022.xlsx
2022-12-02,PAG BOLETO SELETROAR PARCELA 3 DE 3,20947,0.0,129.17,"17.887,92",CAIXA,Despesa com serviços,Peças,../data/raw/BANCO CAIXA - 2022.xlsx
2022-12-02,PAG BOLETO EMBALATEC,20952,0.0,2529.02,"15.358,90",CAIXA,Despesa com produtos,Materiais de Consumo,../data/raw/BANCO CAIXA - 2022.xlsx
2022-12-05,ENVIO TEV CONTABILIDADE-HONORÁRIOS E FECHAMENTO ANUAL ,51622,0.0,983.0,"14.375,90",CAIXA,Despesas administrativas,Contabilidade,../data/raw/BANCO CAIXA - 2022.xlsx
2022-12-05,DB CEST PJ,112022,0.0,69.0,"14.306,90",CAIXA,Despesas financeiras,Despesas bancárias,../data/raw/BANCO CAIXA - 2022.xlsx
2022-12-06,DEB P FGTS,572169,0.0,1341.41,"12.965,49",CAIXA,Despesa com pessoal,FGTS,../data/raw/BANCO CAIXA - 2022.xlsx
2022-12-06,ENVIO TEV LUAN - PAGTO DE SALÁRIO,61023,0.0,936.18,"12.029,31",CAIXA,Despesa com pessoal,Salário,../data/raw/BANCO CAIXA - 2022.xlsx
2022-12-06,ENVIO TEV MARINA - PAGTO DE SALÁRIO,61042,0.0,1448.61,"10.580,70",CAIXA,Despesa com pessoal,Salário,../data/raw/BANCO CAIXA - 2022.xlsx
2022-12-06,ENVIO TEV ROBSON - PAGTO DE SALÁRIO,61045,0.0,1871.99,"8.708,71",CAIXA,Despesa com pessoal,Salário,../data/raw/BANCO CAIXA - 2022.xlsx
2022-12-06,ENVIO PIX OSIEL - PAGTO DE SALÁRIO,61050,0.0,1885.5,"6.823,21",CAIXA,Despesa com pessoal,Salário,../data/raw/BANCO CAIXA - 2022.xlsx
2022-12-06,ENVIO PIX LAURA - PAGTO DE SALÁRIO,61055,0.0,1012.01,"5.811,20",CAIXA,Despesa com pessoal,Salário,../data/raw/BANCO CAIXA - 2022.xlsx
2022-12-06,ENVIO PIX ELISABETE - PAGTO PRO-LABORE,61059,0.0,1078.68,"4.732,52",CAIXA,Despesa com pessoal,Pró labore,../data/raw/BANCO CAIXA - 2022.xlsx
2022-12-12,CRED TED PANASONIC DO BRASIL LIMITADA NFS-e 2233,341,3908.4,0.0,"8.640,92",CAIXA,Receita com serviços,Panasonic,../data/raw/BANCO CAIXA - 2022.xlsx
2022-12-14,CRED TED BRASANITAS HOSPITALAR HIGIEN NFS-e 2237,237,350.0,0.0,"8.990,92",CAIXA,Receita com serviços,Outras,../data/raw/BANCO CAIXA - 2022.xlsx
2022-12-16,CRED PIX HORFRAN COM ELETRO MOVEIS LTDA NF-e 3974,161219,120.0,0.0,"9.110,92",CAIXA,Receita com serviços,Outras,../data/raw/BANCO CAIXA - 2022.xlsx
2022-12-19,CRED TED - PAGSEGURO INTERNET LTDA,290,1414.99,0.0,"10.525,91",CAIXA,Receita com serviços,Outras,../data/raw/BANCO CAIXA - 2022.xlsx
2022-12-19,ENVIO TEV ROBSON 13º SALÁRIO PARC. FINAL,191600,0.0,630.67,"9.895,24",CAIXA,Despesa com pessoal,13º salário,../data/raw/BANCO CAIXA - 2022.xlsx
2022-12-19,ENVIO TEV LUAN 13º SALÁRIO PARC. FINAL,191605,0.0,581.49,"9.313,75",CAIXA,Despesa com pessoal,13º salário,../data/raw/BANCO CAIXA - 2022.xlsx
2022-12-19,ENVIO PIX LAURA 13º SALÁRIO PARC. FINAL,191611,0.0,159.51,"9.154,24",CAIXA,Despesa com pessoal,13º salário,../data/raw/BANCO CAIXA - 2022.xlsx
2022-12-19,ENVIO PIX OSIEL 13º SALÁRIO PARC. FINAL,191615,0.0,197.95,"8.956,29",CAIXA,Despesa com pessoal,13º salário,../data/raw/BANCO CAIXA - 2022.xlsx
2022-12-19,ENVIO PIX THIAGO 13º SALÁRIO PARC. FINAL,191619,0.0,292.35,"8.663,94",CAIXA,Despesa com pessoal,13º salário,../data/raw/BANCO CAIXA - 2022.xlsx
2022-12-19,ENVIO TEV LUAN ADIANTAMENTO DE SALÁRIO,191935,0.0,487.74,"8.176,20",CAIXA,Despesa com pessoal,Salário,../data/raw/BANCO CAIXA - 2022.xlsx
2022-12-19,ENVIO TEV LUAN FÉRIAS COLETIVA,191938,0.0,888.0,"7.288,20",CAIXA,Despesa com pessoal,Salário,../data/raw/BANCO CAIXA - 2022.xlsx
2022-12-19,ENVIO TEV ROBSON FÉRIAS COLETIVA,191941,0.0,986.66,"6.301,54",CAIXA,Despesa com pessoal,Salário,../data/raw/BANCO CAIXA - 2022.xlsx
2022-12-19,ENVIO PIX LAURA FÉRIAS COLETIVA,191946,0.0,745.18,"5.556,36",CAIXA,Despesa com pessoal,Salário,../data/raw/BANCO CAIXA - 2022.xlsx
2022-12-19,ENVIO PIX OSIEL FÉRIAS COLETIVA,191949,0.0,1053.46,"4.502,90",CAIXA,Despesa com pessoal,Salário,../data/raw/BANCO CAIXA - 2022.xlsx
2022-12-19,ENVIO PIX THIAGO FÉRIAS COLETIVA,191953,0.0,780.02,"3.722,88",CAIXA,Despesa com pessoal,Salário,../data/raw/BANCO CAIXA - 2022.xlsx
2022-12-20,PG ORG GOV - DAS,201612,0.0,2080.62,"1.642,26",CAIXA,Despesas tributárias ,Outras,../data/raw/BANCO CAIXA - 2022.xlsx
2022-12-20,ENVIO TEV MARINA - PAGTO QUITAÇÃO DE RESCISÃO,201616,0.0,1128.64,"513,62",CAIXA,Despesa com pessoal,Aviso prévio / Multa rescisória,../data/raw/BANCO CAIXA - 2022.xlsx
2022-12-21,CRED TED FRESNOMAQ INDUSTRIA DE MAQUINA NFS-e 2240,341,1555.0,0.0,"2.068,62",CAIXA,Receita com serviços,FRESNOMAQ,../data/raw/BANCO CAIXA - 2022.xlsx
2022-12-21,CRED TED - PAGSEGURO INTERNET LTDA,290,850.38,0.0,"2.919,00",CAIXA,Receita com serviços,Outras,../data/raw/BANCO CAIXA - 2022.xlsx
2022-12-21,ENVIO PIX JACLEILSON - PAGTO DE TERCEIROS,211659,0.0,946.08,"1.972,92",CAIXA,Despesa com serviços,Mão de obra,../data/raw/BANCO CAIXA - 2022.xlsx
2022-12-21,ENVIO PIX MAIKO - PAGTO DE TERCEIROS,211703,0.0,622.56,"1.350,36",CAIXA,Despesa com serviços,Mão de obra,../data/raw/BANCO CAIXA - 2022.xlsx
2022-12-21,ENVIO TEV SIMONE PAGTO DE TERCEIROS ,212204,0.0,520.0,"830,36",CAIXA,Despesa com serviços,Mão de obra,../data/raw/BANCO CAIXA - 2022.xlsx
2022-12-22,PAG FONE - LIGGA TELECOM ,221941,0.0,149.9,"680,46",CAIXA,Despesas administrativas,"Telefonia (Celular, Fixo, Internet)",../data/raw/BANCO CAIXA - 2022.xlsx
2022-12-22,PAG FONE - NET FONE ,221944,0.0,123.56,"556,90",CAIXA,Despesas administrativas,"Telefonia (Celular, Fixo, Internet)",../data/raw/BANCO CAIXA - 2022.xlsx
2022-12-22,PAG FONE - CELULAR,221945,0.0,57.61,"499,29",CAIXA,Despesas administrativas,"Telefonia (Celular, Fixo, Internet)",../data/raw/BANCO CAIXA - 2022.xlsx
2022-12-23,CRED TED - PAGSEGURO INTERNET LTDA,290,1660.47,0.0,"2.159,76",CAIXA,Receita com serviços,Outras,../data/raw/BANCO CAIXA - 2022.xlsx
2022-12-23,CRED TED SPRINGER CARRIER LTDA NFS-e 2241,341,9310.87,0.0,"11.470,63",CAIXA,Receita com serviços,Spring,../data/raw/BANCO CAIXA - 2022.xlsx
2022-12-29,CRED PIX HORFRAN COM ELETRO MOVEIS LTDA NFS-e 2231,291429,120.0,0.0,"11.590,63",CAIXA,Receita com serviços,Outras,../data/raw/BANCO CAIXA - 2022.xlsx
